000000000000000000000000000000000000000000000000000000000000000000000000000000000000000000000000000000000000000000000000000000000000000000000000000000
000000000000000000000000000000000000000000000000000000000000000000000000000000000000000000000000000000000000000000000000000000000000000000000000000000
000000000000000000000000000000000000000000000000000000000000000000000000000000000000000000000000000000000000000000000000000000000000000000000000000000
000000000000000000000000000000000000000000000000000000000000000000000000000000000000000000000000000000000000000000000000000000000000000000000000000000
000000000000000000000000000000000000000000000000000000000000000000000000000000000000000000000000000000000000000000000000000000000000000000000000000000
000000000000000000000000000000000000000000000000000000000000000000000000000000000000000000000000000000000000000000000000000000000000000000000000000000
000000000000000000000000000000000000000000000000000000000000000000000000000000000000000000000000000000000000000000000000000000000000000000000000000000
000000000000000000000000000000000000000000000000000000000000000000000000000000000000000000000000000000000000000000000000000000000000000000000000000000
000000000000000000000000000000000000000000000000000000000000000000000000000000000000000000000000000000000000000000000000000000000000000000000000000000
000000000000000000000000000000000000000000000000000000000000000000000000000000000000000000000000000000000000000000000000000000000000000000000000000000
000000000000000000000000000000000000000000000000000000000000000000000000000000000000000000000000000000000000000000000000000000000000000000000000000000
000000000000000000000000000000000000000000000000000000000000000000000000000000000000000000000000000000000000000000000000000000000000000000000000000000
000000000000000000000000000000000000000000000000000000000000000000000000000000000000000000000000000000000000000000000000000000000000000000000000000000
000000000000000000000000000000000000000000000000000000000000000000000000000000000000000000000000000000000000000000000000000000000000000000000000000000
000000000000000000000000000000000000000000000000000000000000000000000000000000000000000000000000000000000000000000000000000000000000000000000000000000
000000000000000000000000000000000000000000000000000000000000000000000000000000000000000000000000000000000000000000000000000000000000000000000000000000
000000000000000000000000000000000000000000000000000000000000000000000000000000000000000000000000000000000000000000000000000000000000000000000000000000
000000000000000000000000000000000000000000000000000000000000000000000000000000000000000000000000000000000000000000000000000000000000000000000000000000
000000000000000000000000000000000000000000000000000000000000000000000000000000000000000000000000000000000000000000000000000000000000000000000000000000
000000000000000000000000000000000000000000000000000000000000000000000000000000000000000000000000000000000000000000000000000000000000000000000000000000
000000000000000000000000000000000000000000000000000000000000000000000000000000000000000000000000000000000000000000000000000000000000000000000000000000
000000000000000000000000000000000000000000000000000000000000000000000000000000000000000000000000000000000000000000000000000000000000000000000000000000
000000000000000000000000000000000000000000000000000000000000000000000000000000000000000000000000000000000000000000000000000000000000000000000000000000
000000000000000000000000000000000000000000000000000000000000000000000000000000000000000000000000000000000000000000000000000000000000000000000000000000
000000000000000000000000000000000000000000000000000000000000000000000000000000000000000000000000000000000000000000000000000000000000000000000000000000
000000000000000000000000000000000000000000000000000000000000000000000000000000000000000000000000000000000000000000000000000000000000000000000000000000
000000000000000000000000000000000000000000000000000000000000000000000000000000000000000000000000000000000000000000000000000000000000000000000000000000
000000000000000000000000000000000000000000000000000000000000000000000000000000000000000000000000000000000000000000000000000000000000000000000000000000
000000000000000000000000000000000000000000000000000000000000000000000000000000000000000000000000000000000000000000000000000000000000000000000000000000
000000000000000000000000000000000000000000000000000000000000000000000000000000000000000000000000000000000000000000000000000000000000000000000000000000
000000000000000000000000000000000000000000000000000000000000000000000000000900000000000000000000000000000000000000000000000000000000000000000000000000
000000000000000000000000000000000000000000000000000000000000000000000000000000000000000000000000000000000000000000000000000000000000000000000000000000
000000000000000000000000000000000000000000000000000000000000000000000000000000000000000000000000000000000000000000000000000000000000000000000000000000
000000000000000000000000000000000000000000000000000000000000000000000000000000000000000000000000000000000000000000000000000000000000000000000000000000
000000000000000000000000000000000000000000000000000000000000000000000000000000000000000000000000000000000000000000000000000000000000000000000000000000
000000000000000000000000000000000000000000000000000000000000000000000000000000000000000000000000000000000000000000000000000000000000000000000000000000
000000000000000000000000000000000000000000000000000000000000000000000000000000000000000000000000000000000000000000000000000000000000000000000000000000
000000000000000000000000000000000000000000000000000000000000000000000000000000000000000000000000000000000000000000000000000000000000000000000000000000
000000000000000000000000000000000000000000000000000000000000000000000000000000000000000000000000000000000000000000000000000000000000000000000000000000
000000000000000000000000000000000000000000000000000000000000000000000000000000000000000000000000000000000000000000000000000000000000000000000000000000
000000000000000000000000000000000000000000000000000000000000000000000000000000000000000000000000000000000000000000000000000000000000000000000000000000
000000000000000000000000000000000000000000000000000000000000000000000000000000000000000000000000000000000000000000000000000000000000000000000000000000
000000000000000000000000000000000000000000000000000000000000000000000000000000000000000000000000000000000000000000000000000000000000000000000000000000
000000000000000000000000000000000000000000000000000000000000000000000000000000000000000000000000000000000000000000000000000000000000000000000000000000
000000000000000000000000000000000000000000000000000000000000000000000000000000000000000000000000000000000000000000000000000000000000000000000000000000
300000000000000000000000000000000000000000000000000000000000000000000000000000000000000000000000000000000000000000000000000000000000000000000000000000
100000000000000000000000000000000000000000000000000000000000000000000000000000000000000000000000000000000000000000000000000000000000000000000000000000
100000000000000000000000000000000000000000000000000000000000000000000000000000000000000000000000000000000000000000000000000000000000000000000000000000
133000000000000000000000000000000000000000000000000000000000000000000000000000000000000000000000000000000000000000000000000000000000000000000000000000
111000000000000000000000000000000000000000000000000000000000000000000000000000000000000000000000000000000000000000000000000000000000000000000000000000
111300000000000000000000000000000000000000000000000000000000000000000000000000000000000000000000000000000000000000000000000000000000000000000000000000
111100000000000000000000000000000000000000000000000000000000000000000000000000000000000000000000000000000000000000000000000000000000000003003330000000
111100000000000000000000000000000000000000000000000000000000000000000000000000000000000000000000000000000003300000000000000000000000003001001113300000
111130000000000000000000000000000000000000000000000000000000000000000000000000000000000000000000000000000001100000000000000000000000031031331111100000
111110330000000000000000000000000000000000000000000000000000000000000000000000000000000000000000000000000031103000000000000000000000011011111111130000
111110110000000000000000000030300000000000000000000000000000000000000000000000000000000000000000000000000011131000000000000000000000311311111111110000
111113110003000000003000003313100000000000000000000000000000000000000000000003000000000003000000000000300311111000000000000000333030111111111111110000
111111113001303000031030001111100000000000000003000000000000000000000000000001330300000031000000000000103111111300000000000000111313111111111111113000
111111111031101000011310331111130000300000030031000000030003000000000000003031110100300311000003300003101111111130000330000003111111111111111111111000
111111111011131300311113111111110000100030010011300000010001000000000003301011113100103111303031100331131111111110030113300001111111111111111111111300
111111111311111133111111111111113333133313313311133333313331333333333331131311111133131111131311133111111111111113313111133331111111111111111111111133
121111111212111111111111211111111111121111111121111112111111112211111112111111211111112111111111111111111111111111111111111111111111111211111111121111
112112111111111211211121111211212111211111112121111111111111211111111111111211112111111212111112111211111111211111211111111111111111112111112111111111
111111211111111111212111111111111111212111122111111111121111211112112112221111111111111121111111111111111111111111111211111111111111111111111112111112
111111111111111111111111111111111112121111112211121111111111111111111111111121111111211111111111111111111111111111111111211111211111111111111121111111
111111111121111111211111111111112111111111211111111111111112211111111111111111111111211111121111211121211111111111121111111111111111211112111211211111
111111111211111111111111111112111111111111111111111111221211121111211111221111111111111111111211111111111212111111121211111111111111111112111211111111
111111111111111111111111111112111111111111111111111111111221111111121111121111111111121121212111111121121111111111111111121111121111112111111111111111
111211111111111111111121111111111211111111111111111121111121111111112111111111111112211112111111111111111111211211111112111111111111221111111111111111
121112111121111121221112111111111211121111111111111111112111111112111111111111121211121111111111112111111121111111111111121211111111111111111111111211
111221111111112111121111121111121111111111111111111111121111221211111111112211111111111211111111112112111111112111111111111111111111112111111111111111
122111111111211122111111121111111111111121111111111211111111121211211112111111112111111111111211121111111222111221121111211211111111121112112111111111
111121111121111211111111121111111122112111112111111121111111111111111211111111111111111111111121111111111111121111211111111211121111111211121111111211
111111111121111111111111111111111111111121212111111111211111111111211111111121122111111112111112111121112111211111211111111112111111111211111111111121
111111121111112111111112111111111111121111211111112112111111111111111111211111111111111112111111211121111111112211111211112112111121111121111111111112
111111111111111111111112111111111121112112111111121111111111111211121121111111112111111111111121121111111111211111112121112111111111211111111111111111
111111112111111112111111111112111111111111112111111211111111212111111111221111111211111212111111111111111111111121112111111111121111111121111111221111
111111111112122111111112111112111111111111111111121121211121111211211111112111111111112111111111111111121111111112111111111111111112111111112111111111
211111111111111111111211211111121111122121111121111111111111111111111111112111111211111111111211111212111222112112111112111111111111111211111111111111
211111121111111112111111111111211111111111211111121121111111111111111211121112111111112111111111111121111111211111112111121111111112111211211112111121
211211111111111111111111111211111111111121111111211111112111111111111121112111111121211111222221112111111211111211111211112111111112111111112111211111
111111111111111111211121112111111111111112112211121121111211111111111111111111111121111111111111111111111112111111121111111111111111112111121211111111
211111111111111111121111111121211211111111121211111111111121111111121121121111111111111111112122111111111111121111111121111112121212111111111111121111
112112111111111111112112111121111121211111111111211111111122112111211211112111111111111111211111211111111111111112111112111111111111111111111111111111
111111111111111111111111111111112112111111111111111112111111211111111211111111121111111111111111111122112111121112112121111111111111111111111111111121
111111111111211211111112111111111211111111111111111111111111111121111111121111111111211112111111111111121111111111121111111111111111111111211112112111
111111111121111211112112111111111111111211111112111111111121112122111121111121111111111111111111111111211121111111111111121111111121121111111111211111
112111111111111111211111111111111111111111111111111111111111111111111111111111111112211111211121111111112111111111111111111111121211111111121121112111
112111112211111111111211121111121111112112112111121111111111111111111111111111111111112111121121111111111212111111111211121111111121211211111111111111
121111111111111111121221111111211111111111111111122111112111212111121111111111111111111112111111112111211111221212111111111111111111111111111211111111
112111211111212111111121211112211112111111112111111112111111111111111112221122111111121111112111111111212112111111111211111112211111211111111111111221
121111111121111112111121111111111111111111111111111111111111111111111112112121111112111211111111111211111111111111211111111121111111111111111111121111
111111111211221121112111111111121211212211111111111111111112211112121112111111211111111111121111111211111111111111111112112211121121111111111111111111
111111111111112111111112111111111211112111111121221111121111111111112121111211111112111211122211112111112111111112221111111121111111111111111122112111
111111111111111121111111112112122111211211111111112112111211121111111112121111111111211111111111111111111111221121111111211111111112111111111111111211
122111111111111111111111121111121211121111111111211211111111111111111211111211112211111111211111111111122211111111111111111121112111111111111111111111
111111122221111121111121112112111111111111111111111111211111121112111112121211212111111111121111111112111111111111112121111111111111112211111111111111
111111111211111112121111111111121111111121121111111111111111121112111111111111111111111111121111111111111111111111121112111111111111111211111112112111
121111111121111111111111111111111111221112111111111121121111211121211121111111111121211111111112112112111111111121111112111111111211111111111211111111
111111111111121111112121112112111111111111111111121111211111111112211112111111111121111111122111212121111111111111111111111111111111111111111111111221
111111121111111121111221111111111111112111111111212111111111111111111111111112111211121211111111111211122111112121111111211211211112211111111211211111
111211122111111121111111111111111111111111111111111111111111121121111111112111111111111111111111111111111112111121111112111111111111111111112112111112
111111121111121111121111112211111111112111111111112111111111111112111111111111212111111211111111121111111111211112121111111111111112111111111111111111
111111111111221111111111121111211111111111222111111121111111111111111111112111211111111121211121211121111112112111111111111111111112211111111112121111
111122111211111111211111122111121121211111122221211111111111111111111111111211111221221111111111112111111111112121112111111111111111111111111211111121
111111111111211111111112111111111111121121111211211211111111111111111111111111111111111111211112111111111121122111121111111121111111111112111121111111
111111211111111111111111111111111121121111111111112122111111121221111111111111111211111111121111121111111111211111112111112111111111111111111211111121
111111121122111111111111111112121111111111112111111111111121111111111112121111121111111112111111111111111121111221211111211111111111122111212111211111
111111121111111121121112211111122111111121111111111111111111212111112111111211221111112122111111111111211122121111121111111111111111221111211111111111
111111111111111111111111112111111211121112111111111221111111111111111111112211111211112111211111111111121111211111111112111112111121111111111111111111
211111112111111111112212111111111111211111111111111111111121221121111111111111111111111111111111111111111111111112211111111111111211111111111111111111
111112112111111111211211111111111111111111111111112111211112111111121111112211111211112211111112111111211111211111111211111111112111111111111111112211
111211111111111111111111212111111221111111111221111111111111121111111111111112111111111221111111111111111111111111211111111211121111111111111111111111
111111111111111111111111121111111121111111111111111111111111211111111111212111121111111111111211111112111111111112111111111211111111112112121111112121
111112111121111111112121211111111111111121211111211111111111111121111111111121211111111112221111111111111211111121211111111211111111111111111112111112
111112111111111111211111111121121111111111112111111111111111111111121111111121111111211111111111111111112111121111111111111111222211112111111111111212
211111111111111121111121111111111111111111111111111211111221211211111111111111111211111111111111111111111111111111111111211112111111111111211111111111
111212121111112111111111112111111121111111211111111121111211111111111212111121111111111111111111211211111111111111111111111211111111111111111121111112
112111111111111111111111111111111121221111121212112111112111111111111111121111121111211111111121111111121221111111211111111112111111211111111211211112
211111121211111111111111121121111111121112111111111111111111111111111121121111111111111111112111121111111112211112111121111111111111111111111111121121
211111111121111111111121111211221111112111122112111111211211111211211111111211111112121111111111121111111111111211111111111111111112111111111111112111
111121111111111211111111111111111211111111121111111111112111111111111111221211111211111211111111211121111111111111111211112211111111112111111121111211
211111221111111111112112111121121111111212111211112111111111121111211111111111211111111112111212111111111211121111111112111111121111111112121111111111
212112111111111111121211111111111111212212211122111111121111111111111111111111112221111111121111111111221111111211111121211111111121112111121111111111
111211211111111111111112112112111112121111111111111111111112211111112111111111111112111111111111211111112111112111111111111111112111111111111112111112
121111111111121111111111111211121111111111221111111111111112111121111111211111111111111111211111111211112221111111211212211121112121112111111111111112
112111111111111111111111211111111121111111111121111111111211112111111111111111111111111111111111112121111111211111111111112221112112211111211121111111
111111111112111111111112211111211111111111112111211111112111111111121121111111111111111211212111111121111111111111111111121111111111111111111111111112
121121111111111111112111111111111111211121112211111111211112121112111211112211111121121211111111211122111111111111111111211111112112111112111122211111
112111111111111111111211111111112111221111111111111112121112111111111111111111121121112111121122111111111111111111111221111111122111111121211111111221
112111111211111111111111211112111111111111111111111121121111111111111111121111211211122111121211112111111111112211121111211111111111111112111112111111
111111111211111111112111222111121111112111121111111111111211111122111111111111111111211211111112111111211111112112211121111111112111111211111111111121
111111111111111112222111121111211111111111112111111111121111111112121222111111111111111121111111122111121111111111112112211211111111111121221121111121
111121111111111111212221111111122211111121111112111111121111111211111112111111111111111111111111111111111111111111111121122112111111111111121111111212
111111111212111111211121211111111112111111111111111111121211211111111111111111211211111111211111112111111111111111111112111111111111112111111111122111
211111121112111211111111111222121111221122121111212111112121111111111211111111111122111111111111111111111111111111111111111111211111111111111111111211
111111111111111111111111111111111121111211211111111111111111111111111112212111111121211111111111111112211111211111111111111111111211111112111111121111
111122112121111111121111111111221112111111111111111111112111121111111111121111111111122112111121111221111111112111111121111212211121212111111111111211
112111121121111111111111111111111111111111111111111111111211111111111112111111111111111211111111211111111111111112111111111111211111111111122111121111
222111211112211111111211111111111111121111211112111111111111211211111111111111111111111111111121111112111111111112111111111111111111111111111112111121
111111111111111111121211111211111111121111112111121211211111111121111111111112111111111111111111111111111121111111121111121111121111121111111111111111
111111111211121111111111111111111111111111111111111211211111111211111111121111111111121111111111111112211111111111111111111211111111111212111111111112
111211111111111111112111111111111121111111111111111121111111111121221111121111111111121211111121111112211121111112111111111121111111121111111111111111
211112111111111111111221112111112111121211111111111111111121111111122111121111112121111111111111112121111112211111112112111111111211111212111111111121
111111111121121112111211111122111111111111111111112111111211111111111111111111111211121111111111111111111111111111121111111111111111111112111111112112
211111112111111111111111111111211112111111211211111111111211121111111121121111111111111211112111211211111121212111112211111111111111111211111111111111
211111111111211112111121111111111211121111111111111111111111121112111111111211121221211111111111121111112111212111111111211111111112121112112111111112
211112111112111211111121111111111111111111121121111121211112112111221111111111111111111111122211111112111111211121111111211111111111111211121111111111
121111111111221111112111112112111122111211212121111112211112111111111112111111111122221111111111111112111111111111111111111111111111111111121211111121
111111111111111121111111111111111121111121111122111111111111121111111111111122111111111111121111211111121111111111111111111111111111111111111111121111