000000000000000000000000000000000000000000000000000000000000000000000000000000000000000000000000000000000000000000000000000000000000000000000000000000
000000000000000000000000000000000000000000000000000000000000000000000000000000000000000000000000000000000000000000000000000000000000000000000000000000
000000000000000000000000000000000000000000000000000000000000000000000000000000000000000000000000000000000000000000000000000000000000000000000000000000
000000000000000000000000000000000000000000000000000000000000000000000000000000000000000000000000000000000000000000000000000000000000000000000000000000
000000000000000000000000000000000000000000000000000000000000000000000000000000000000000000000000000000000000000000000000000000000000000000000000000000
000000000000000000000000000000000000000000000000000000000000000000000000000000000000000000000000000000000000000000000000000000000000000000000000000000
000000000000000000000000000000000000000000000000000000000000000000000000000000000000000000000000000000000000000000000000000000000000000000000000000000
000000000000000000000000000000000000000000000000000000000000000000000000000000000000000000000000000000000000000000000000000000000000000000000000000000
000000000000000000000000000000000000000000000000000000000000000000000000000000000000000000000000000000000000000000000000000000000000000000000000000000
000000000000000000000000000000000000000000000000000000000000000000000000000000000000000000000000000000000000000000000000000000000000000000000000000000
000000000000000000000000000000000000000000000000000000000000000000000000000000000000000000000000000000000000000000000000000000000000000000000000000000
000000000000000000000000000000000000000000000000000000000000000000000000000000000000000000000000000000000000000000000000000000000000000000000000000000
000000000000000000000000000000000000000000000000000000000000000000000000000000000000000000000000000000000000000000000000000000000000000000000000000000
000000000000000000000000000000000000000000000000000000000000000000000000000000000000000000000000000000000000000000000000000000000000000000000000000000
000000000000000000000000000000000000000000000000000000000000000000000000000000000000000000000000000000000000000000000000000000000000000000000000000000
000000000000000000000000000000000000000000000000000000000000000000000000000000000000000000000000000000000000000000000000000000000000000000000000000000
000000000000000000000000000000000000000000000000000000000000000000000000000000000000000000000000000000000000000000000000000000000000000000000000000000
000000000000000000000000000000000000000000000000000000000000000000000000000000000000000000000000000000000000000000000000000000000000000000000000000000
000000000000000000000000000000000000000000000000000000000000000000000000000000000000000000000000000000000000000000000000000000000000000000000000000000
000000000000000000000000000000000000000000000000000000000000000000000000000000000000000000000000000000000000000000000000000000000000000000000000000000
000000000000000000000000000000000000000000000000000000000000000000000000000000000000000000000000000000000000000000000000000000000000000000000000000000
000000000000000000000000000000000000000000000000000000000000000000000000000000000000000000000000000000000000000000000000000000000000000000000000000000
000000000000000000000000000000000000000000000000000000000000000000000000000000000000000000000000000000000000000000000000000000000000000000000000000000
000000000000000000000000000000000000000000000000000000000000000000000000000000000000000000000000000000000000000000000000000000000000000000000000000000
000000000000000000000000000000000000000000000000000000000000000000000000000000000000000000000000000000000000000000000000000000000000000000000000000000
000000000000000000000000000000000000000000000000000000000000000000000000000000000000000000000000000000000000000000000000000000000000000000000000000000
000000000000000000000000000000000000000000000000000000000000000000000000000000000000000000000000000000000000000000000000000000000000000000000000000000
000000000000000000000000000000000000000000000000000000000000000000000000000000000000000000000000000000000000000000000000000000000000000000000000000000
000000000000000000000000000000000000000000000000000000000000000000000000000000000000000000000000000000000000000000000000000000000000000000000000000000
000000000000000000000000000000000000000000000000000000000000000000000000000000000000000000000000000000000000000000000000000000000000000000000000000000
000000000000000000000000000000000000000000000000000000000000000000000000000900000000000000000000000000000000000000000000000000000000000000000000000000
000000000000000000000000000000000000000000000000000000000000000000000000000000000000000000000000000000000000000000000000000000000000000000000000000000
000000000000000000000000000000000000000000000000000000000000000000000000000000000000000000000000000000000000000000000000000000000000000000000000000000
000000000000000000000000000000000000000000000000000000000000000000000000000000000000000000000000000000000000000000000000000000000000000000000000000000
000000000000000000000000000000000000000000000000000000000000000000000000000000000000000000000000000000000000000000000000000000000000000000000000000000
000000000000000000000000000000000000000000000000000000000000000000000000000000000000000000000000000000000000000000000000000000000000000000000000000000
000000000000000000000000000000000000000000000000000000000000000000000000000000000000000000000000000000000000000000000000000000000000000000000000000000
000000000000000000000000000000000000000000000000000000000000000000000000000000000000000000000000000000000000000000000000000000000000000000000000000000
000000000000000000000000000000000000000000000000000000000000000000000000000000000000000000000000000000000000000000000000000000000000000000000000000000
000000000000000000000000000000000000000000000000000000000000000000000000000000000000000000000000000000000000000000000000000000000000000000000000000000
000000000000000000000000000000000000000000000000000000000000000000000000000000000000000000000000000000000000000000000000000000000000000000000000000000
000000000000000000000000000000000000000000000000000000000000000000000000000000000000000000000000000000000000000000000000000000000000000000000000000000
000000000000000000000000000000000000000000000000000000000000000000000000000000000000000000000000000000000000000000000000000000000000000000000000000000
000000000000000000000000000000000000000000000000000000000000000000000000000000000000000000000000000000000000000000000000000000000000000000000000000000
000000000000000000000000000000000000000000000000000000000000000000000000000000000000000000000000000000000000000000000000000000000000000000000000000000
300000000000000000000000000000000000000000000000000000000000000000000000000000000000000000000000000000000000000000000000000003000000000000000000000000
100000000000000000000000000000000000000000000000000000000000000000000000000000000000000000000000000000000000000000000000000031000000000000000000000000
130300000000000000000000000000000000000000000000000000000000000000000000000000000000000000000000000000000000000000000000000011300000000000000000000000
110130000000000000000000000000000000000000000000000000000000000000000000000000000000000000000000000000000000000000000000000311100000000000000000000000
113113000000000000000000000000000000000000000000000000000000000000000000000000000000000000000000000000000000000000000000000111100000000000000000000000
111111033000000000000000000000000000000000000000000000000000000000000000000000000000000000000000000000000000000000000000003111130300000000000000000000
111111311000000000000000000000000000000000000000000000000000000000000000000000000000000003000000000000000000000000000000001111110100000000000000000000
111111111033000000000000000000000000000000000000000000000000000000000000000000000000000001000000000000000000000000000000031111113100300000000000000000
111111111311000000000000000000000000000000000000000000000000000000000000000000000000000031300000000000000000000000000000011111111130130000000000000000
111111111111300000000000000003300000000000000000000000000000003000000000000000000000000011100000000000000000000000000000311111111113110000000000000000
111111111111100000000000000001130000000033000000000000000000001000000000000000000000000311100000000000000000000000000000111111111111113003000000000000
111111111111130000000000000031110000000011300000000000000000031000000000000000000030030111130000000000000000000000000003111111111111111031000000000000
111111111111110003000300000011110000003311100000000000300000011300000000000300330010313111113300000000000000000000000031111111111111111311300000300000
111111111111110331003100000311113000031111133300000000130330311100000000000133110310111111111100300300000000000000000011111111111111111111100300100003
111111111111113111001130003111111300011111111100003033110113111133030000003111113113111111111133100100300000000000300311111111111111111111100103100001
111111111111111111331113331111111133311111111133331311113111111111313333331111111111111111111111133133133333333333133111111111111111111111133131133331
111121111111111111111111112211111111111111111111111121111111111111111211111111111221112111111111111122111111111111111111111111111111121111111112111112
111111112111221111112111111111211111121211111111121111112111112111111211111111111111111112112111111121111211121111211211111111111111112111111111111111
111112111111111112211111112111111111111111111112111211111111111211111111111211111111111112111121111211111111211111111211111121112111112111121111111111
111211112111112111112111111112111111111111211111111121211111112111111111111111212111111111112112111121111111111111112211111111112111111211121111111111
211112211111111111111111111112111111111111111111111111112111111111111111111111111122121111111112111111112112111111111111111112122111112111111111111112
211111121112111121111111111112211112112111111221212211111111111111111111111121111111111121112111121122111221111111111111121211111111111111111111121112
111111111111221111212121111111112111121112111111111222111111211111211211111111111111111111111112111111221111111112111211112211211111111111111211111111
121112112111111111111111111111111111211112111121112111112111221111111111111111121112111122121111122111111111211111121121111112112121121111111111211111
111111111111111111111121111111111111111111111211211111111111111112111121111211211111111111111111111111112111111111111121111212121111111111112111211111
121212121121111111121111111121111121121121111111111111111111211111122111111111112211111111111112211111111212121121121111111111111111111111111111112111
112111211111111111111121111111211211211121211111111121111211111111111211111111111111111111111111111221111111111111211212111111112111121111211111111111
122111111111111111111111111111111121112111111111111211111111111111111111112121211111111122121111121211111111111111111111111111111111111111111111111111
111111112111111112111112111111111211111111111212111111111211111112111111111111221211111211111111111121211111111111111111111111111111111211111221111212
111112212111111111111112112121111112121111111121111111111111112211111211111111121112211111121112112112121111112112111111111111111111111111111111112111
111111111111111111111111121112111111111112111111111111111211111111211111111112111111111111112112111211111111112121111111111211111111111211111112111111
111112111211111111111112111111121111111212121111111111111111111121111111111111111111111111112121111111111111111111111111111111112121111111121111111211
111111111111111112111111111111111111121111121111111211112112111111111211111111111111111111111111221112111111111111212121111112211111221111111121111211
111111111111111111111112111111211111121111111111112111112211111111211111111111211211112111111111111111111111111111211121111111111111111112111221111111
111211111111111122111211221112111111211111111111211111111111111111111111111211211111111221112111111221112111111111112121112111111111111212111111122111
111111112112111111111111111111121111111211111111111111111111212111111111112111111111111111121111111112212111111111111111111111111111111111111111111111
211111111211111111221111111111111111121121111121211211111111111111212122111211111211111111111111211111111111111111111111111212111111212111111111111111
211112111111112211121111121211111111112221121111111211111121111121111212121212111111111111121211121121111121211111111111121111221111121111111112122111
111111111111111121111211121121111111111211111121111112111111111112121111121211111111111111211111112121111111111221112111111121111212111121111211111112
112211111111211111112121121111111112111111112111112111111111111111111111112111111211111111111112112121112111111111111211111111121111211111111111111121
112111111111121111111111121111111111111112111121111111111111121111121211121211111111121111121111111112211111111121111111121112111111111111111111212111
111111111211122111211111111111111111111111111111112211111111111112121111111111221112112111121111121211111111111121111121121211112111111122211211111211
112111111111111111121111111111112112111111111211111211111211111111211111111111112121111121111121111111111211211111111111111111111111121111112111122211
111122121111111111121121211111111112111111111111211121111111111111111111111111211111111111111211221211212122111221111221111111111111111111111211211111
111111112121111211111111111221111122111111111111221111111211111111111111111111121112111111222111111111111111211111112111221111111111111111111111111111
111111111111111111121112112111111111111111111112111112111111222111121122111121111111111112111211111111111211211212111111111111111111111112121111212111
111111121111121111111111111111121112221111121111111111111121111111112111111112111111121111121121111111111112211211111111111122111111111111111111112121
111111111111111121111111111212111112121111111121112112111111111111111111111111111111111211111111112121111111211112211111111111112111111211111122121111
111111112211111111111111111111111111112111111112111111111111111111111111111112111111111121111111112111111211111111111111111111111211112111111111121112
111111111121111111111111211211111111121211111212111211112211211111111111112111112111111211111211111111111111112211111111111211111111211211121112111111
111111111111111211111111111111111121111111112111111111111211112111111112211121111111111211112211112211111111111111111111111111111112111111121121111111
111111211111111111111111212111111111111211111211111111111112111111111111112211112212211111111111111221211111111111112211121111111111111112111211121211
111111111212111111111111111111111111111111111111111121121112211112212111111121111111121111111122111111111111121111111111121211111111111121111111111111
111121121111112111111111121111111111111112111111111111121111111111111111121111211221111121121111111212111121121111111111111121111112111112111111121111
111111122221111221111111111121111111111211111111111211111112111111111111122111211121112111111111111111111111111112121121111111111111111111111111111122
111111121211111111111112112111111111111111111111111111111111111111111111111111111111111111121111111112211211111121111111222112111111111111112111111111
111111111211111111121111111122121111111121121111111111211111112111111111121111112111111111112112111211111111211112111121121111211112111212111111211112
111121111121111111111111111211121111111111111111111211212121211112111111111211111111221111111112121211112111111111111122112111111122111111121211111111
111111111111111111112211121111111111111111111111121111112211111112111111211111112111121112111111211111112211211111111111121112111211211111112111211111
111111112111111221111111121111111121111111111121111211111111112212111111111111111111211111212111111111111111112111221112111111121112111111111111221111
211111111111211112111111111112211111211112111111111211121121111111111111111111111111211111111111111111121112112121122111111111111111111111111111111111
111111111211111111112111121111111111111211111111111121111111121111112211111111112112211111221111121111111111111112111112112121111111111111111112111111
111111121111211111221111111111111211111111111112112111111211111111121111111111111111111111111112111111111121111121111121111111111121111211121112211111
111111111111111111111111211111111121111111111121111111111111111111111211112111121121221111121221111211111111121111111111111111121212111111221121111111
111211112111111121112112111111111111111111211111111111111111111111111111111111211211211111212111111111111121111111112111111111111111212111111111211111
111111111111111111111122222111111111111111111111111111111111211122111111111121111112121111112111112211111111112111111111121111121211121111111211111111
111211111111112111111111121121111111121111111211111111111111112112111111111111111122121211111111111111111111111211112111211121111111111111111111111111
111121212111111111111121111111121211211111111111111111122121211211112121111121111111111111121111111111111111111111112121111111111111111121111111111111
111111111121111211211111111221221211121111111121111111111121111121111111211121211111121111111111111111112112111111111111111111112111111111111221111111
111111111211111111111121121211211111111111111121111111121111211111111121121211111111212111111111111211111111111111111111111111111111111112121111211111
111211111221221111111112111112111121212121111121111111112111111111112212121211211211112122111221111111111111111111111111112211112111111111111111111112
111111111111111111112111112111111111211111121111111121122111111111121111112211111211111111111111122111111111111112111111112111111211111221221111111111
112111121111111111121111211112212121112111111111112111112111112111111211111111112111211111121112111111111111112111112111111211112221121111221111111111
211111111121111111112111111111112111111111111111211112112111111121111111111111111121211111112221121112111111111111111221111111111112111111112111111111
211211211221111111112212121212111211111111121111111111211111221111211112111212111111111111111111211111111211111211111112112111111111111112211111111111
111111111121121221111111212111112111112111111211211111111111111111121111121111111111111111111111112111111211211111211111111121121111111121111111111211
111112111111111111111111111121211111111111121122121111211111111111211121111111111112111111111111111111111211121111111111111111211111111111111111211212
121121111121111211111112111211111111111111111112111111111111111111111111111111111121111111111122111112221211111211111111112111121111111111121111111111
111211111111111111111111112111211121111111111111111111111112111211111111111111111211111111111111111111111211111121111111112111121111121111111111111111
121212111111121111111211111111111112111111111111111112112111112111111111111111211111111111111211121112111111111111111111111111112111111111111211221111
111111111122111111111122111111111111111111111111111111111111121111112112111111111111111111111111111111211111121111112111111111121121111111111111111211
111111111111121121121111111122111111211112111111111112111112111211111111111111111111111121111121112111111111112111111111112111111112111112111111111111
111211211111111121121112111112111111111111111111111112111111121111211111111111111121111111111111111121111111111111112121111112212111112111111111111111
112111111121111111111111111121111111111121211121111121111111111111111111111112111111111111111211121111111111111111121111211112111111111121112111111111
211111221112211211111111111111212111111221111111111111211112111111111111211111111111111111111111111222111111111111111111111121111211211111111111111111
112111111111111111111111111111111111111212111111111211121111111111111111111212111111112111111111112211111111121111111211112111111211121111111111111111
211211111111111111111121111121111211111111111121111111111111111111121111111111111111111121111112112111221111211111112111111211111121112121111111111111
111111111111111111211121111111111212111111111111111111111121111111111111111211121111121111111111111111121111121211111111111111111111211211111111111112
111111112111111111111111111111211111111111111112112111111111211211112111111111111111111112121111211111111111112111111112112111121111111111111111211211
121111212122111111111111212111111111111111111111211111111111211111111111111111111111111111111111111121111112111112111111111111111112112111111121111211
111111111111111111111211111111111111111112111121211111111111211111111112121111121111111211111111111111221212211211211111211111112211121111112121112111
122121111111111112112111111111111111111111111111111111111111211121111111111111211111111111212111211111111211111111111211111111111111211111112111111111
111111111111111111111111121111111111111121211111111111111111111111111112211111112111121111111111111111211111111111111112211121112111112111112111111121
211111111111211112111111111112111211111111221121111111112111111112111112111121111211111111111211111111111211122122111112121112111111121111122211121221
221112121111111111121111111111111121111111111111111111211111121111211111111111211211111111111211111112111111111111111111111111211211111111111111111211
111121211111121111111211111111111111111111211111111112111121211121111111211111111111211111221111111111111111211112111111111211111112111211111121111111
112111111111111211111111111111111211111211111112111112111212111111112111111111121111111211121121111111111111111111112111111121111111111111111111111211
111111111112111121111121112111121112111111111111121111211111111111211111111111211111111112111111111111111112111121111111111111111111111211121211211111
111111111111211111111211111211111112112111211111111111112111111111211211111111211111111111111111211111111122211111112211112111111111111111111111111111
112112111111111121121111111111121111211211121211111111111111212111111111111111111111112111111111111111111111111112111111122111111211112111111111111111
112111111111111111111111111111112111111121111111112111111111111111121111112111111111111111111112111111111111111111111111111111111111121111112111112211
112112111111112111111111112111111121111111111111111111111111111111111111111111111211111211211121211121111111111111111111111111111211112121111121221111
112221111111212111122111112121111111111111111111111112111211211111111111111111111111111211211111111211111111111111111111111111111111112111111111121212
111211111112121111111111112111111111111111111211111211111112211111121111121111111121111111211111111112111111111212112121111111111112112112111111111111
111111111111111121111111111111111111211111111121111111111211111112111111111112112121111111112111121111111112112111111211112111111111211111121111211111