000000000000000000000000000000000000000000000000000000000000000000000000000000000000000000000000000000000000000000000000000000000000000000000000000000
000000000000000000000000000000000000000000000000000000000000000000000000000000000000000000000000000000000000000000000000000000000000000000000000000000
000000000000000000000000000000000000000000000000000000000000000000000000000000000000000000000000000000000000000000000000000000000000000000000000000000
000000000000000000000000000000000000000000000000000000000000000000000000000000000000000000000000000000000000000000000000000000000000000000000000000000
000000000000000000000000000000000000000000000000000000000000000000000000000000000000000000000000000000000000000000000000000000000000000000000000000000
000000000000000000000000000000000000000000000000000000000000000000000000000000000000000000000000000000000000000000000000000000000000000000000000000000
000000000000000000000000000000000000000000000000000000000000000000000000000000000000000000000000000000000000000000000000000000000000000000000000000000
000000000000000000000000000000000000000000000000000000000000000000000000000000000000000000000000000000000000000000000000000000000000000000000000000000
000000000000000000000000000000000000000000000000000000000000000000000000000000000000000000000000000000000000000000000000000000000000000000000000000000
000000000000000000000000000000000000000000000000000000000000000000000000000000000000000000000000000000000000000000000000000000000000000000000000000000
000000000000000000000000000000000000000000000000000000000000000000000000000000000000000000000000000000000000000000000000000000000000000000000000000000
000000000000000000000000000000000000000000000000000000000000000000000000000000000000000000000000000000000000000000000000000000000000000000000000000000
000000000000000000000000000000000000000000000000000000000000000000000000000000000000000000000000000000000000000000000000000000000000000000000000000000
000000000000000000000000000000000000000000000000000000000000000000000000000000000000000000000000000000000000000000000000000000000000000000000000000000
000000000000000000000000000000000000000000000000000000000000000000000000000000000000000000000000000000000000000000000000000000000000000000000000000000
000000000000000000000000000000000000000000000000000000000000000000000000000000000000000000000000000000000000000000000000000000000000000000000000000000
000000000000000000000000000000000000000000000000000000000000000000000000000000000000000000000000000000000000000000000000000000000000000000000000000000
000000000000000000000000000000000000000000000000000000000000000000000000000000000000000000000000000000000000000000000000000000000000000000000000000000
000000000000000000000000000000000000000000000000000000000000000000000000000000000000000000000000000000000000000000000000000000000000000000000000000000
000000000000000000000000000000000000000000000000000000000000000000000000000000000000000000000000000000000000000000000000000000000000000000000000000000
000000000000000000000000000000000000000000000000000000000000000000000000000000000000000000000000000000000000000000000000000000000000000000000000000000
000000000000000000000000000000000000000000000000000000000000000000000000000000000000000000000000000000000000000000000000000000000000000000000000000000
000000000000000000000000000000000000000000000000000000000000000000000000000000000000000000000000000000000000000000000000000000000000000000000000000000
000000000000000000000000000000000000000000000000000000000000000000000000000000000000000000000000000000000000000000000000000000000000000000000000000000
000000000000000000000000000000000000000000000000000000000000000000000000000000000000000000000000000000000000000000000000000000000000000000000000000000
000000000000000000000000000000000000000000000000000000000000000000000000000000000000000000000000000000000000000000000000000000000000000000000000000000
000000000000000000000000000000000000000000000000000000000000000000000000000000000000000000000000000000000000000000000000000000000000000000000000000000
000000000000000000000000000000000000000000000000000000000000000000000000000000000000000000000000000000000000000000000000000000000000000000000000000000
000000000000000000000000000000000000000000000000000000000000000000000000000000000000000000000000000000000000000000000000000000000000000000000000000000
000000000000000000000000000000000000000000000000000000000000000000000000000000000000000000000000000000000000000000000000000000000000000000000000000000
000000000000000000000000000000000000000000000000000000000000000000000000000900000000000000000000000000000000000000000000000000000000000000000000000000
000000000000000000000000000000000000000000000000000000000000000000000000000000000000000000000000000000000000000000000000000000000000000000000000000000
000000000000000000000000000000000000000000000000000000000000000000000000000000000000000000000000000000000000000000000000000000000000000000000000000000
000000000000000000000000000000000000000000000000000000000000000000000000000000000000000000000000000000000000000000000000000000000000000000000000000000
000000000000000000000000000000000000000000000000000000000000000000000000000000000000000000000000000000000000000000000000000000000000000000000000000000
000000000000000000000000000000000000000000000000000000000000000000000000000000000000000000000000000000000000000000000000000000000000000000000000000000
000000000000000000000000000000000000000000000000000000000000000000000000000000000000000000000000000000000000000000000000000000000000000000000000000000
000000000000000000000000000000000000000000000000000000000000000000000000000000000000000000000000000000000000000000000000000000000000000000000000000000
000000000000000000000000000000000000000000000000000000000000000000000000000000000000000000000000000000000000000000000000000000000000000000000000000000
000000000000000000000000000000000000000000000000000000000000000000000000000000000000000000000000000000000000000000000000000000000000000000000000000000
000000000000000000000000000000000000000000000000000000000000000000000000000000000000000000000000000000000000000000000000000000000000000000000000000000
000000000000000000000000000000000000000000000000000000000000000000000000000000000000000000000000000000000000000000000000000000000000000000000000000000
000000000000000000000000000000000000000000000000000000000000000000000000000000000000000000000000000000000000000000000000000000000000000000000000000000
000000000000000000000000000000000000000000000000000000000000000000000000000000000000000000000000000000000000000000000000000000000000000000000000000030
000000000000000000000000000000000000000000000000000000000000000000000000000000000000000000000000000000000000000000000000000000000000000000000000000010
300000000000000000000000000000000000000000000000000000000000000000000000000000000000000000000000000000000000000000000000000000000000000000000000000310
130000000000000000000000000000000000000000000000000000000000000000000000000000000000000000000000000000000000000000000000000000000000000000000000000113
113000000000000000000000000000000000000000000000000000000000000000000000000000000000000000000000000000000000000000000000000000000000000000000000003111
111000000000000000000000000000000000000000000000000000000000000000000000000000000000000000000000000000000000000000000000000000000000000000000000031111
111003000000000000000000003003000000000000000000000000000000000000000000000000000000000000000000000000000000000000000000000000000000000000000000311111
111331000030003000030030331031000000000000000000000000000000000000000000000000000000000000000000000000000000000000000000000000000000000000000000111111
111111330010001330010310111011300000000000000000030000000000000000000000000000000000000000000000000000000000000000000000000000000000000000000003111111
111111110313331110310113111311130000000000000000010000000000000000000000000000000000000000000000000000000000000000000000000000000000000000000001111111
111111113111111113113111111111113000000000000000310000000003000000000000000000000000000000000000000000000000000000000000000000000000000000003031111111
111111111111111111111111111111111300000000000000113000000001300000003000000000000000000000000000000000000000000000000000000000000000000000031311111111
111111111111111111111111111111111103330000000003111000000031100000001000000000000000000000000000000000000000000000000000000300000000300000311111111111
111111111111111111111111111111111101110300300001111000030311100000331000000000000000000000000000000000000000030300000000000100000000100003111111111111
111111111111111111111111111111111131110103100031111330013111130003111300000000000000000000000000000300000000013100000000003100000003100001111111111111
111111111111111111111111111111111111113101100311111110311111110001111100000000000000000000000330303103000000311130003000301130000001130031111111111111
111111111111111111111111111111111111111131130111111113111111113031111100300300003000333000000113101101000000111113001303131110000331110311111111111111
111111111111111111111111111111111111111111113111111111111111111311111133133133331333111333333111131131333333111111331131111113333111113111111111111111
111111111111111111111111111111111111112111111111121111111112111211112111121111211112111111112111111121111111112111112111111112111111121111111211112112
211111112111111111121111111111111111111112111111111111111111111111111112111111211211111111112211111111111111111211121121121111211121111111111111111121
111111111111211111111111211111211111111212221111111121112111111121111111111111111111111111211111111111111111211122111111111121111112111111211112112111
111111111111111121112111111111111121111111111111111112111111111111121111111121111111111111111112111111111111111211211111111111111111111112111111111111
111111111111111211112121111111212111111111111211121111112111111111111111111111111111111111111111111111121121112111211111111112111111111121111211111112
112111121111111111111111112121111111111111211111111111111111111121112111111111211111111111111112112211111111122111111112111121111111121111221111212121
111111111111111111111211111121111111111111121111111111111111112111211112111111111111111122111111111211111111111211111111111111111211111111211111111111
211111111111112112111111111111111112211111112111111211112111111111121111111111111122111122111111111111111121211111211111111112112111111111211111111111
112111111111211111111111111111111112111121121111111111111111111111111111121111111111111111111111111122211111211111111111112111111111111221111111111122
111111111111111111112112111112221111111111211111111111212111111121112111212111111111112111111111112111111121111111111111111211111111111111111111111112
111211212111111211112112111122121111122111111111111111111111112111111121111111111111121111211121111111121111111111211212111111111111111211111211111211
111211112111121111111111111111111111111111111111111122111111111111111111111111121111111111111222111111111121111111111111111111111111111111111111111112
121111112211111111111111112111111111122121121112111211111111111121111121111111111111111121121112211111111111211111111111121111121111111111111111111111
111112112111111111111121111111111111111111111111111211211112121111111112111111112111111111111111211111111121121111111111111111211111111111111111111121
111111111111211211111112121111111111111111111111111111111111121111211111111112121111111121111121111211111111121111111111112111111111111211111111111111
111111111111222111111111211121211111211112221121111221111111111211112111111111111121212121211111112111111111111111121111111111111111111111111111111111
111111211111111111111111111111111111111111121111121111211121111111211111111112211111111111212111121112111111211111111211121122111121112111111111211211
111111111121111111111111111111111111111111111121112211111111111111111112111112111111111112111211111111121111111211111111111111111111111111111121111211
111111111111112111111111111112121121111111111111111111111111111211122111111112111121111111111112111211211122211111122111111111111111111111111111212112
121121111211111111111111121111111111111111111112111112211111121111111111111111111121111121111111111111121111112111112111111111111111112112111111121111
111111111111111211212221111112211121111121111111112111111111111121121111111122111111111111112111112121211111111111111121111111111111111111111111111121
111111121111112112211211211111111111111111111111111111111211121111111111111111111111112111121111111211111121111111111111112121111121111121211111111111
111111121111112111111121111111111111111111111111111111111211211111211111111112211111121111111111211122122111211111121111111211111112111112111121211111
121211112112111111111111111111121111111112211111111111112111111111111111122111111211111111111121121111111111111111111111111221111112111211111212111111
111121111111111111111111112111111111111111111111111111111111111111111111111111111111111111121211221121111111211211121111111121211111111111111112111111
111111121121112112111122111111112111111112111112111112121112111111111121111111121111111111112221111111111111112211112111111111111121121122221211111111
211122211111111111111122111111121111111211111122112121112211111121112121111111111121111111111221111111111111211121121112111211111111211111112111121121
121111112111111121111212111111111212121211111111111121121111121121112111112121111111121111111111111111111111111111111211211111111111121111111211111111
111111121111111111111111111122111111111111111111221111111111111112111211111111111111112111111112111111111111121121111111121111111111111111211112111121
121111111122111112211111121111111112111111211111111111111122111111111111111111111111111111211111221111111111111111121111111121111111111111111111111211
111111111112111111111111211121111121111111112111111112211121111121111111122111111111111111111111111111211111211111111111111211111111211211121112111121
112111111111121111111111211121211111121111112111111111111111111211112111112111121111121112111111111111111112111111111111111212111211111122111111111121
111111211111111111112111111111111111111111111111112111122111111111111111111211111111211111121112111111211211121211112111111111112111111111111111111112
222111111111111111111111111111111121211111111111111112111111111111211112112111111121111111121111211111112111111111112111112111111111111112211211112111
111111111111111121111111111112211111111111112111211111121111112111121111111111211111112111121111111111111111111111111111111111121112111111111112111111
112112111111221111212111121111111111111112211111112212112111111111111112111121111111111121111111111111111112111111112111111111111111111111111111111111
211111111112111111111111111111111121211111111111111111111111211111111111111111111111111122111111212111111211111111112111111121111212111111121111111111
111111111111111111111111111111111111111111211111111121111111121111111211122211111111111211111111111121112121111211211111111111212111211112111111111111
112111111111121111111111112111211112111112111111111111112211112111111112111111211112111111211111111111111111111121111111111111111121111211111111121111
112111111111111111111111111111111112212111111112111211112111111111121121111112111111111111121111111111112111112111111111211111121121111111112121112111
111121112211111111112111121111111111111112111211211111111111111111111111121111211121211121111112121111111111111111111112112111111111111111211121211211
111111111111211111111111211112111111111111111111211112111111111111111112112111111111111111211111111111111111211111211211111111111121111211111111121211
111111111111111111211111111211111111211121111111121111211211121111111121111111121211111111111111111121111221111111111111111121111111111111111121111111
111111122121211211111111211111111211111111211111111111121111111111111111111111111111111121112111121111111111111112121121211111111111111111111211111111
111111111112111112121111111111111112111111111111112111111121111111112111112111111212111111112111111111112112111111111111111111111111111111111121211111
112111211111111111111111111111111211111111121112111121111111111111211111111112111111111111121121112121211111111111111111111111111111111111111111111111
211111111122111121111111111111111111111111111112111211112111111211211111111111111111111112111211211111212111112111111112111111221111112112111111111111
111111112111211111111111111111111111111111211111111112211121112111111111111111111111211211111111111112111111121122111112111111121112111111111111112112
111111111112111111111111111111121111111211111111111111112122112211111111111211111111111221111111111111111111111211111111111121111112211112121112221111
111111211111111111111211211111111211111111111211111212211111111111111121111111111111111111111212122211111111112111111111111111111111111121111211111121
111111111111111111111111111111211111211111111111111111111111111111121211121111211111111111111112122112121111111111111111111112212111111121211112111111
111111211111111122112111111221111111111111111111111111111111112212121121111111111211111111111111111112111212111112121111211121111111221111111211211111
112111111111211112111111111111111111111211111211111111212111211211111112121211112111111111111112111121111211111111111111111111111112111111112111121111
111111111121111111111112211111111111121111111111111111111111111111111111111111111111111111111111121111111111111111111111111111121111211112111111111111
121211111111112111111112111111111211111111111121111211111111111111121111211111211111121111112112111212111112111111111111112211121111211111111221111111
111111111212121121112111111111111111111111111111111211212111111111211111111111111211111111212211111111111111111111111111111211111111111111121111111111
111122111111122111111111111111111121121111121111111111111111111112111111211112111111121211111211111211211111221111111111111111121111111111111111122111
111111112112111111111111111111111111111111111111121111111211111111111111112111111111111111111111112111111112111111111111211111111111111111111111111111
211112111111111112211111211111211211111111111111111221111121121111111111111111111121111211111111111111111211111111121111211111111111111111121111111121
221111121111121111111111121112111111111111111111121111111211112111111221112112111121111111112111111111111111111111111111111111111111121121111122111121
111111111111111121111112111112111111111111111111211111111111211112112111121111112111211111111111221111111111111211111111121111111111112111111121111111
121111112111111212111111111111111111111111111111111111111111211211121111111121211121111111111112111121112112211211111112111111111111112112211111111111
111111111211112111111112111211111111112111111211121112111111111112121111111211112112111111111112112111111121111111111121111211111111111111111111111111
111111111112112121111111111112111111111111111111111111111112221111111112112122111111111111211111112111111111111121111211111111111112121112111111112221
111111111111111111121111112111121121112111112111221111112111111112121211211111112112111112111111111112111111111111111111111111111211112211121111221111
111111111112221111111112111121111111111111111111111111112211111111221211111111121111121111211121111111111111211121111111111111121111211121121111112121
111111111111111221111211111121111111212111111111121111111111111111111111221111121111111111111121111111111111111111112111111121111211111111111212111111
211112111111112111111111112211111111121111112111111121111121111111121211111111111112111111111111122111211121211211211111112112111111111111111111111121
111111211111111111111111111111211221111111111111211122211111111111111111111111111111111111111211111121111111111111111121111122111111211111211111111111
211211121111112121211121211121211112111112121111121211111111111111111111111211111111111111111212111111111111111121111111111111112121111111211111221111
111211112111111211111111111211111111111111111111111111211111111112122111111111122111111221111111111221211121111111111111121111111111111111121111121112
111111111212111112111111111112111111112121111111112111211111112112111111111111111111111122211111112212111121111121111111111111111111211111111122111111
111121121111211111111111111111111211111111111111111111111111111111111122211211111111111111121111111111111121221111121211111111111111111111111121111211
121111111121112111111111111112121211121112121111211111112111111111111121111111111111111111111111122111112211111121111111121111112112111111112111111111
111111111121111111111111112111111111121111121111111111111111121111121111111111111111112111112112121121121111211111111211112221111111111211111112121121
111111112211121111111111211111111111111111111111112111111112111211111111111211111122111111111211111111111211111121121111111111121112221211111112111111
121211112111111111111211111111112111121112111111111111111111111121111121122111111111111111111111111211111211211111112111111122111111111111221111111111
111111111111112112111111111112111211111111111111111111111111211111112111211111111211111121111111111111121121111112111111112111211111111111112211111111
111121211211111111111111111111111121111111111111111111121111111111111111111111211112211111111122111111111111111111111111211111111112122111112111211112
111111111112111111122211111111111111111221111111111111211111111112111111111111111211121111122111211111112111111111111111111121211111121111112211211111
211111111112112211111111111111111211111111111122111111121211112111121111111111111111111111111111111211112211111121111111111112111112111111111111111121
112112121112112211122111121212111111111111111111121111211111111121111121121111111121111121111112111111111121211111111111111111111112111211111111111111
111112111211211111111111211111121112111111111111111111111111212111111112111111121111111111111111111111111111111121112111121111111111111111111112111111
111111111111121111112111111111121221111121111111112111111111211111121211111111111111112121111112211111111211111112211111121111112211111111111111211111
111111111111111111111111111111121111111111121212111211112121111111111111111111112111211111111111211111111112111211111111121111111112111111121111111111
211111111111111111111122111111111111111111111111211221221211121111111111111212111111121111111121111112111111111211111112111111121111111111112111111111
111211112111111111211212111111111121111111211111211111111111111121121111111111111111111111111111111111111111111111121211112111111211112111111111111111
212211112111112111211111211111111111111111111121111111111111111122211111121111111121111112211111111121111111122112111211112111111111121111112111111112
111111211111111211111111111111111211111111121111211211211111111111111111111111111211111111111111111111111121111111111111121211121111111112111211111211