000000000000000000000000000000000000000000000000000000000000000000000000000000000000000000000000000000000000000000000000000000000000000000000000000000
000000000000000000000000000000000000000000000000000000000000000000000000000000000000000000000000000000000000000000000000000000000000000000000000000000
000000000000000000000000000000000000000000000000000000000000000000000000000000000000000000000000000000000000000000000000000000000000000000000000000000
000000000000000000000000000000000000000000000000000000000000000000000000000000000000000000000000000000000000000000000000000000000000000000000000000000
000000000000000000000000000000000000000000000000000000000000000000000000000000000000000000000000000000000000000000000000000000000000000000000000000000
000000000000000000000000000000000000000000000000000000000000000000000000000000000000000000000000000000000000000000000000000000000000000000000000000000
000000000000000000000000000000000000000000000000000000000000000000000000000000000000000000000000000000000000000000000000000000000000000000000000000000
000000000000000000000000000000000000000000000000000000000000000000000000000000000000000000000000000000000000000000000000000000000000000000000000000000
000000000000000000000000000000000000000000000000000000000000000000000000000000000000000000000000000000000000000000000000000000000000000000000000000000
000000000000000000000000000000000000000000000000000000000000000000000000000000000000000000000000000000000000000000000000000000000000000000000000000000
000000000000000000000000000000000000000000000000000000000000000000000000000000000000000000000000000000000000000000000000000000000000000000000000000000
000000000000000000000000000000000000000000000000000000000000000000000000000000000000000000000000000000000000000000000000000000000000000000000000000000
000000000000000000000000000000000000000000000000000000000000000000000000000000000000000000000000000000000000000000000000000000000000000000000000000000
000000000000000000000000000000000000000000000000000000000000000000000000000000000000000000000000000000000000000000000000000000000000000000000000000000
000000000000000000000000000000000000000000000000000000000000000000000000000000000000000000000000000000000000000000000000000000000000000000000000000000
000000000000000000000000000000000000000000000000000000000000000000000000000000000000000000000000000000000000000000000000000000000000000000000000000000
000000000000000000000000000000000000000000000000000000000000000000000000000000000000000000000000000000000000000000000000000000000000000000000000000000
000000000000000000000000000000000000000000000000000000000000000000000000000000000000000000000000000000000000000000000000000000000000000000000000000000
000000000000000000000000000000000000000000000000000000000000000000000000000000000000000000000000000000000000000000000000000000000000000000000000000000
000000000000000000000000000000000000000000000000000000000000000000000000000000000000000000000000000000000000000000000000000000000000000000000000000000
000000000000000000000000000000000000000000000000000000000000000000000000000000000000000000000000000000000000000000000000000000000000000000000000000000
000000000000000000000000000000000000000000000000000000000000000000000000000000000000000000000000000000000000000000000000000000000000000000000000000000
000000000000000000000000000000000000000000000000000000000000000000000000000000000000000000000000000000000000000000000000000000000000000000000000000000
000000000000000000000000000000000000000000000000000000000000000000000000000000000000000000000000000000000000000000000000000000000000000000000000000000
000000000000000000000000000000000000000000000000000000000000000000000000000000000000000000000000000000000000000000000000000000000000000000000000000000
000000000000000000000000000000000000000000000000000000000000000000000000000000000000000000000000000000000000000000000000000000000000000000000000000000
000000000000000000000000000000000000000000000000000000000000000000000000000000000000000000000000000000000000000000000000000000000000000000000000000000
000000000000000000000000000000000000000000000000000000000000000000000000000000000000000000000000000000000000000000000000000000000000000000000000000000
000000000000000000000000000000000000000000000000000000000000000000000000000000000000000000000000000000000000000000000000000000000000000000000000000000
000000000000000000000000000000000000000000000000000000000000000000000000000000000000000000000000000000000000000000000000000000000000000000000000000000
000000000000000000000000000000000000000000000000000000000000000000000000000900000000000000000000000000000000000000000000000000000000000000000000000000
000000000000000000000000000000000000000000000000000000000000000000000000000000000000000000000000000000000000000000000000000000000000000000000000000000
000000000000000000000000000000000000000000000000000000000000000000000000000000000000000000000000000000000000000000000000000000000000000000000000000000
000000000000000000000000000000000000000000000000000000000000000000000000000000000000000000000000000000000000000000000000000000000000000000000000000000
000000000000000000000000000000000000000000000000000000000000000000000000000000000000000000000000000000000000000000000000000000000000000000000000000000
000000000000000000000000000000000000000000000000000000000000000000000000000000000000000000000000000000000000000000000000000000000000000000000000000000
000000000000000000000000000000000000000000000000000000000000000000000000000000000000000000000000000000000000000000000000000000000000000000000000000000
000000000000000000000000000000000000000000000000000000000000000000000000000000000000000000000000000000000000000000000000000000000000000000000000000000
000000000000000000000000000000000000000000000000000000000000000000000000000000000000000000000000000000000000000000000000000000000000000000000000000000
000000000000000000000000000000000000000000000000000000000000000000000000000000000000000000000000000000000000000000000000000000000000000000000000000000
000000000000000000000000000000000000000000000000000000000000000000000000000000000000000000000000000000000000000000000000000000000000000000000000000000
000000000000000000000000000000000000000000000000000000000000000000000000000000000000000000000000000000000000000000000000000000000000000000000000000000
000000000000000000000000000000000000000000000000000000000000000000000000000000000000000000000000000000000000000000000000000000000000000000000000000000
000000000000000000000000000000000000000000000000000000000000000000000000000000000000000000000000000000000000000000000000000000000000000000000000000000
000000000000000000000000000000000000000000000000000000000000000000000000000000000000000000000000000000000000000000000000000000000000000000000000000000
330000000000000000000000000000000000000000000000000000000000000000000000000000000000000000000000000000000000000000000000000000000000000000000000000000
110000000000000000000000000000000000000000000000000000000000000000000000000000000000000000000000000000000000000000000000000000000000000000000000000000
110000000000003000000000000000000000000000000000000000000000000000000000000000000000000000000000000000000000000000000000000000000000000000000000000000
113000000000001000000000000000000000000000000000000000000000000000000000000000000000000000000000000000000000000000000000000000000000000000000000000000
111333300300331303000000000000000000000000000000000000000000000000000000000000000000000000000000000000000000000000000000000000000000000000000000000000
111111103103111101000000000000000000000000000000000000000000000000000000000000000000000000000000000000000000000000000000000000000000000000000000000000
111111131101111131300000000000000000000000000000000000000000000000000000000000000000000000000000000000000000000300000000000000000000000000000000000000
111111111131111111100000000000000000000000000000000000000000000000000000000000000000000000000000000000000030000100000000000000000000000000000000000000
111111111111111111100000000000000000000000000000000000000000000000000000000000000000000000000000000000000010303130000000000003000000000000000000000000
111111111111111111133300000000000000000000000000000000000000000000000000000000000000000030000000000000000310131110000000000301300000000000000003030000
111111111111111111111100000000000000000000000000000000000000000000000030000000000000000313000000000000000113111113300000000131103000000000000001010000
111111111111111111111130000000000003300000000000000000000000000000000013000000000003003111000000000000003111111111100000003111101000000000000031313000
111111111111111111111110030000000001100300000000000003000000000000000311000003000001031111300000000000001111111111130000031111131003000000000011111000
111111111111111111111113310030003331130100003300000001033000000000003111000031000031011111100300000000031111111111110300011111111331000000000311111000
111111111111111111111111113013301111113100301133000331311303000003031111330011330011311111130100300033011111111111110100311111111111300003000111111300
111111111111111111111111111311131111111133131111333111111131333331311111113311113311111111113133133311311111111111113133111111111111133331333111111133
111111111111111111111121111111111111111111111111112111121111111111111112111111111111111111221111111112111211111111111111111111221211121111121211211111
111111111111112122211211121121111111111111111111111112111111111111111111112121111211111111111111111121111111121111211111111111111111221221111211111111
111211111111211112111111111111111111121111111111111111111111112111111111212111111111111111111111111221211212111121121121121111112111112111111211111111
111212111111112111121111121112112111111211111111111111211111121111111111111111111121111111121112111211111112111111111111121111111111112111111111111212
111111121121111121111112211121111111112111111122111112111112111111111112211111121111111111111122111111111211111111112212111111111111121112111212112111
221111211111211111111111111111111111111121111211111111121111121111111111121111111111112112111111111111121112121111111111111111111111111222111111111111
111111111111121121111111111111111111211211111112111111111111111121111112121111121111111121111112111111121111211111111111121112111111111111111221111111
111111121121111111111111111111111111111111111112111211112111111111111111111211122211111111111221121121111111111111211122111211121211111111111111111111
111111111111112121111211111121211111111111111111111111111111111111121111111121111111111211111112111111111211112111111111111111111221111111111111211111
211111111211111111211212111111111111121111111111111111111111121111111111111111111111111211112111111121121212111111111111111111111111111111121111111111
111111111111111111111111212122121111111111111211111211111112111111111111211111111112111212111111111111122112111111111121111111111111111111121111111111
111111111111111112111111111111111111111221111111111111121112111111112212121211111121211111111111211121111211111111111212112111111211111112111111111111
111111211111211111212111112111121111211111112111121111111121211111111111111111112121111112121111111212112121111112112211211111111122111211111111111121
112111111122111112111121111121211111111111111111211112111111111112212111111121111111111111212111111111121111112121111111111211111212111211112211211111
122111111112111111111111111111211111111111111112111111111211121111111111111121111112211221212111211111112211111111211111111111111111121111111111111112
111111111121111211111122211212111111111112111111111111111111111111112111112111121111111212121121111111111122112111221111111111111111111111111111121111
111122111211111112111111121111112111121111111211121122111111111212111111111121111111111111211211122111111112111111111111112111111111111111121121211111
111111111111111111211111121111211111111111111111111111111221111111121111111111111111111111111111111211111121111111111112211111111111111111112111112111
111111221111111111111111111111111111111111111111111212111112211111111111121111121111111111112121111111211211111111111111112111111111111121211111211111
111111122121121111111211211111111211112111111211111111111111111121111111212111111111212111111111111111111111111221111111111111111111222111112112211111
111111111111111211111122111111111211211111111111111111111111111121111111121111122112112111121212111211111112121111112112111211111111212111211111111111
112111111121111111211111111111111212111111121111211111111111211111111111111111111111111111111111111211211111111121111111211111111211111211111121111111
111111211111211111121111111121111111111111211111111121111111111111111111211111111111112221111111122111111121111111111111211111112121121211111111111111
111111111111211111112221121111121211111111111111112211111112211111112111111112211111112111112211111111111111111111121111111121111111111111111111111111
111111121112112111211122111211111111111112211111111111111111121111111111111111111111221111111111111121111111212111111111111211121111111111111111111111
211111111112112111111111111111121111111111111111112112111111111111111111111112121111211111111111111111111211112211111121111111121111111111122111112111
211111111121212111121211121111111111111112111111111111111111111111111111112112111121111212111111111111211111121121121111112111211111111111111121111111
111211111111111121122121111111121111111111111111122111122111121112111211111111211112111111111221111111211111111111112112111111122111212211111211111112
111111111112211111111111111112111111121111111111111212121111111211111211111121111111111121112111112111111111111111111111111212112111111112111111112111
112111121111121111111112121111111111111111111111111111111111221111121111111211111211111111111111211121111111112121111211121111112111112111111111111111
121121212111112212111111111121122111112111111212111112111111121111111111111212111111211111111111111211111112211111111111111111121121111121111111111121
111111111111112111121111111112111112112111121111112111111111111121112211121111111111121111121111111211111112211112111112121111121211111112111211111112
111112111111121112111111112111111121111111121211212221111112112121121111111111111111121112111111111111111121111111111111111111111111111111111111111111
111111112111121111122111111111111111111111111111111111211111211121111111121111111111211111112112121112121122112111111111111121212112111111111121111112
111111121111112111112121111111112111212121111221212211211112111121112112111121112111111121121111112111111111111111111121111111111111112211111111111111
111111111221112112111111111211111121112112111111111211111212111111111111111111111111111111212111111111112111121111111121111111111211111111121121111111
111121111221111112111111111111111111122111111111111121121211111111111111111111111211121111121121111111112112111111111111111111111121112111121121121111
111111111112111112111111111211111112111111111111111111121111111111111111111111111211111111111111111111111111111111111111111111211111111111111111111111
121111111112111111111112112111111111111211211111111121111111111111111111121112112211112111111111111111111111112111111111111111112111111111111121112111
121111111111121111111111211111211112111121111111111111111111111111211111121121111111111111111121212111111122111111111111111121111111121111111112121111
111111211221112121121112221112121111111211111121211112111111221112111211111112112111111111111112112121111111121112111221121211121111121111111111111111
111111111111111111111211211111211111111111111111111111121112111211121111121112211111111111121112111111111111111111111111111111111111111111111111111111
111112121111111111111211111211111111111121111111122111111111111111111111211111111111211111111111111111211111111111111111112111111111111112111111111211
111111111111111121111111111111111111111112111111111111111111121111211121211121111111211111211111111112212111111111111111112211121212111111211211211121
111211111112111111111111112111111111111121111111111111111121111111111111211111111111111111111111112111111111111111122211111112111111111211111121111112
211112111211111111111111111111111112111121112111111211111211111111112111111211112111111111111112111111111111111111111212111112111111122111111111111111
212111111221111111111111111111111111112111111111112112111111211111111211111211111121111111111111111111111111111111111211111111111121111112111211111121
121111112111111111111111121121111211111111212111111111111111111111111111111112221111111111111111121111211111111111111111111111111111111221111111111111
111111121111111111211121111112111112111111111111211111111121111212111112111111111111121112111111111211112111112111121112112111111111111211121111111111
112111111111211121111111111111121111111111111111111111211111112111121111211111111111111111111111111111111111211111111111111211111111211111111111211111
111111121111211211111111111111211111111111111112111211111111111111121111111211111111111111121112121111121111111111121111111121111111111111212111112111
111111121211111112111121121111211211111111121111111111121121111112111111211111211211111111112121112112111111111111121111211111111111112111111111211112
111212111111111121111111111111111111111122111111211211111111111111111111121111111111212211111111221111111212211121221112111111111221111111111111111221
111111111111111111111111111111111111111112111111111111111111111111111212111221111212111122111111111111111111111112111111111211111111121111111112111111
121112112121111111111111111111121111121111211111211111121121111111121111111121211112211111121111112111212111111112111112111111111111111111111111112111
111111111121122111111111112111111111121111121111111121121111121111111111111111212212112111122111121211111111211111121111111111111112111111111111111111
111112111111111111211111111111111111111111111111111111111112111111111111121111111111111111111111111112111111111211111111211211121111111121111111111111
112111111112121112111211112112112111111111111212211111111211112221111111111111111111122111111211111111112111111121111111111111121111211112111111112212
111111111111121111112111111111111111112111111211111111111111111112111111211111111121111111111111111111121112211112111111111112111111211211111111111111
111111211212111211111111111111111111211111111111121112111111111111111111111111111112111211211211112111121111211112111111211111111111111211111112211111
111111111111111111111112211111111111111211111112111112111111111111121112121112111111121111211111211121111112111111211111111111111111121111111111111111
111111111111111111111111111111111112112111111112112211211111111111112111111111111221112111111111111111111111111111111112211111111111111111112221112111
111112111111111122111111111211111112111111211112111211111111111111111111121121111111111111112111122111112111112121111111111112112211111111111112111111
111111111112111111121111111111112111211111111111211112111111111111111111111111111111111211211111111222111111111112111111112111111111211211112211111111
111111111211121111211111111111111111111111111112211111111111111121111111111111122111111111111111111111111111111111112111111111111111211111122121112121
111211111111111211112121111111111111111111211111111111112111111111111111112112121111111111111112111122111111111121112211212111112111111121111111111111
112111111111211111111211111112111111111111111111112121111111112111111111121111211111122111122111111111112211111111121111211111111121112111211111111211
211111121111112111111111111111111121112111111111111111111112111111111111111111111111112121111111121111121111211111111111111211111112111111111121111111
112111111111112111111122111111111111111211111111111111111211111111111111111212111121111111111111211111111111111111111111121112111111111111212211111111
111111111111211112111111111111112111111112111111212111111211111111112111121111111111111111111111111111111211211111112211111121111111111111111111111111
111111111111111111112121111111111121111122111111111111111111111211111211111111211111111121111212111111111111111121111111121121112111211111111112211111
111111111111112111112111111111111111111111212111111111111111111111111111111111111211122121121111121111111111111211111111111212121111111111111112111111
111121111111112111111111111111112111111111111121211111111111122111111111121111211111112111111111121111212111111112111111112212111111111121111111111121
111111111121121111111112111111221111211111112111111111111111111111111111111111111111111111111211111111212111211111121111211111111121111111111121122111
111111112111111211111111111111111111122111111111111121111111111111111111111122112111112112111111111111111211111111111111111111211111111111111121111111
111111111111121111111111111111121111111111111121112211111211111111111121121111111111212111111211111211111111111121121211111112111111121111111111121212
112111112111211111111111111111111112111121111111111111111111121111221111211111111121211211111111121111211111111111111121211111112121111111111111111121
112112111111211111112111111121111111111211121112121111112111211111111111111211111111111111112111212111111111111112111111111111111111211121111121112112
211111211111112111111111111211111111211111111211111111111211111111112211111211111211111121111111111121111111111111112121111111111111111111121111111211
111111121111111111211111111111211111121211111111111111222111111111112112121111111121111111111111112111111211121211111111112111111111221111211121121111
211112211111111211111211111111112111211111111111112111111112111111111111111221111212121211112112111221111111111121111111112111111111211111111111121111
111111211111111111112111111111111111111111111111212111121111111111111111121111211111111111111111111111111111121111111121111211111112121111211111111111
111211112111111121111221111212121111111111112211111112111111112112221121111211111111111111111112112111111111112111111112112121111111111111111121111111
111112112111111111111112111111111112112112111112111111111212121111121111122211111111112111111111111111111121111111111111111111111111211111111211112111
111111222111111111111111111211121111111111211111111111112121121211111111111111111111111111111111122111122211111111111111211112111111211111211211111111
111211221111111111111111111111111111112111111111211111211112111111111211111111111111111111112111111111111111111221111211112111111111111111121111111111
111121121121111111121121121211111111111111111111111122111111111112112211111111121121111111211111112211111111111111111211111112121111111111211111112111
211111111211111111111111211121121111111111112111111112111111111111121211121211112111121111111121121111111111111121111111111211221111111111212111121211
111111111112111211111111111211111111111111211111112111111111111111221121111111111111111112211121121111111111111111111111111111111222212211111112111111