000000000000000000000000000000000000000000000000000000000000000000000000000000000000000000000000000000000000000000000000000000000000000000000000000000
000000000000000000000000000000000000000000000000000000000000000000000000000000000000000000000000000000000000000000000000000000000000000000000000000000
000000000000000000000000000000000000000000000000000000000000000000000000000000000000000000000000000000000000000000000000000000000000000000000000000000
000000000000000000000000000000000000000000000000000000000000000000000000000000000000000000000000000000000000000000000000000000000000000000000000000000
000000000000000000000000000000000000000000000000000000000000000000000000000000000000000000000000000000000000000000000000000000000000000000000000000000
000000000000000000000000000000000000000000000000000000000000000000000000000000000000000000000000000000000000000000000000000000000000000000000000000000
000000000000000000000000000000000000000000000000000000000000000000000000000000000000000000000000000000000000000000000000000000000000000000000000000000
000000000000000000000000000000000000000000000000000000000000000000000000000000000000000000000000000000000000000000000000000000000000000000000000000000
000000000000000000000000000000000000000000000000000000000000000000000000000000000000000000000000000000000000000000000000000000000000000000000000000000
000000000000000000000000000000000000000000000000000000000000000000000000000000000000000000000000000000000000000000000000000000000000000000000000000000
000000000000000000000000000000000000000000000000000000000000000000000000000000000000000000000000000000000000000000000000000000000000000000000000000000
000000000000000000000000000000000000000000000000000000000000000000000000000000000000000000000000000000000000000000000000000000000000000000000000000000
000000000000000000000000000000000000000000000000000000000000000000000000000000000000000000000000000000000000000000000000000000000000000000000000000000
000000000000000000000000000000000000000000000000000000000000000000000000000000000000000000000000000000000000000000000000000000000000000000000000000000
000000000000000000000000000000000000000000000000000000000000000000000000000000000000000000000000000000000000000000000000000000000000000000000000000000
000000000000000000000000000000000000000000000000000000000000000000000000000000000000000000000000000000000000000000000000000000000000000000000000000000
000000000000000000000000000000000000000000000000000000000000000000000000000000000000000000000000000000000000000000000000000000000000000000000000000000
000000000000000000000000000000000000000000000000000000000000000000000000000000000000000000000000000000000000000000000000000000000000000000000000000000
000000000000000000000000000000000000000000000000000000000000000000000000000000000000000000000000000000000000000000000000000000000000000000000000000000
000000000000000000000000000000000000000000000000000000000000000000000000000000000000000000000000000000000000000000000000000000000000000000000000000000
000000000000000000000000000000000000000000000000000000000000000000000000000000000000000000000000000000000000000000000000000000000000000000000000000000
000000000000000000000000000000000000000000000000000000000000000000000000000000000000000000000000000000000000000000000000000000000000000000000000000000
000000000000000000000000000000000000000000000000000000000000000000000000000000000000000000000000000000000000000000000000000000000000000000000000000000
000000000000000000000000000000000000000000000000000000000000000000000000000000000000000000000000000000000000000000000000000000000000000000000000000000
000000000000000000000000000000000000000000000000000000000000000000000000000000000000000000000000000000000000000000000000000000000000000000000000000000
000000000000000000000000000000000000000000000000000000000000000000000000000000000000000000000000000000000000000000000000000000000000000000000000000000
000000000000000000000000000000000000000000000000000000000000000000000000000000000000000000000000000000000000000000000000000000000000000000000000000000
000000000000000000000000000000000000000000000000000000000000000000000000000000000000000000000000000000000000000000000000000000000000000000000000000000
000000000000000000000000000000000000000000000000000000000000000000000000000000000000000000000000000000000000000000000000000000000000000000000000000000
000000000000000000000000000000000000000000000000000000000000000000000000000000000000000000000000000000000000000000000000000000000000000000000000000000
000000000000000000000000000000000000000000000000000000000000000000000000000900000000000000000000000000000000000000000000000000000000000000000000000000
000000000000000000000000000000000000000000000000000000000000000000000000000000000000000000000000000000000000000000000000000000000000000000000000000000
000000000000000000000000000000000000000000000000000000000000000000000000000000000000000000000000000000000000000000000000000000000000000000000000000000
000000000000000000000000000000000000000000000000000000000000000000000000000000000000000000000000000000000000000000000000000000000000000000000000000000
000000000000000000000000000000000000000000000000000000000000000000000000000000000000000000000000000000000000000000000000000000000000000000000000000000
000000000000000000000000000000000000000000000000000000000000000000000000000000000000000000000000000000000000000000000000000000000000000000000000000000
000000000000000000000000000000000000000000000000000000000000000000000000000000000000000000000000000000000000000000000000000000000000000000000000000000
000000000000000000000000000000000000000000000000000000000000000000000000000000000000000000000000000000000000000000000000000000000000000000000000000000
000000000000000000000000000000000000000000000000000000000000000000000000000000000000000000000000000000000000000000000000000000000000000000000000000000
000000000000000000000000000000000000000000000000000000000000000000000000000000000000000000000000000000000000000000000000000000000000000000000000000000
000000000000000000000000000000000000000000000000000000000000000000000000000000000000000000000000000000000000000000000000000000000000000000000000000000
000000000000000000000000000000000000000000000000000000000000000000000000000000000000000000000000000000000000000000000000000000000000000000000000000000
000000000000000000000000000000000000000000000000000000000000000000000000000000000000000000000000000000000000000000000000000000000000000000000000000000
000000000000000000000000000000000000000000000000000000000000000000000000000000000000000000000000000000000000000000000000000000000000000000000000000000
030000000000000000000000000000000000000000000000000000000000000000000000000000000000000000000000000000000000000000000000000000000000000000000000000000
310000000000000000000000000000000000000000000000000000000000000000000000000000000000000000000000000000000000000000000000000000000000000000000000000000
113300000000000000000000000000000000000000000000000000000000000000000000000000000000000000000000000000000000000000000000000000000000000000000000000000
111100000000000000000000000000000000000000000000000000000000000000000000000000000000000000000000000000000000000000000000000000000000000000000000000000
111130000000000000000000000000000000000000000000000000000000000000000000000000000000000000000000000000000000000000000000000000000000000000000000000000
111110300000000000000000000000000000000000000000000000000000000000000000000000000000000000000000000000000000000000000000000000000000000000000000000000
111113130300000000000000000000000000000000000000000000000000000000000000000000000000000000000000000000000000000000000000000000000000000000000000000000
111111110100000000000000000000000000000000000000000000000000000000000000000000000000000000000000000000000000000000000000000000000000000000000000000000
111111113100000000000000000000000000000000000000000000030000000000000000000000000000000000000000000000000000000000000000000000000000000000000000000000
111111111130000000000000000000000000000000030000000000010000000000000000000000000000000000000000000000000000000000000000000000000000000000000000000000
111111111110330000000000000000000000000000013000000000310000000000000000000000000000000000000000000000000000000000000000000000000000000000000000000000
111111111110110000000000000000000000000000311000030003113300000000000000000000000000000000000000000000000000000000000000000000000000000000000000000000
111111111113113000030033000330000000000003111000013031111130000000000000000000000000000000000000000000000000000000000000000000000000000000000000000000
111111111111111000310011303110030000000001111300311011111110000000000000000300000000000000000000000000000000000000000000000300000000300000300303003030
111111111111111003110311131113010000000331111130111311111113000000000000003130000000000000000000000030000030300000003300000100000003100000103131001010
111111111111111331113111111111313033000111111113111111111111300030003003001110000000000000000000003013003010130300001103033130000001130003131111331313
111111111111111111111111111111111311333111111111111111111111133313331331331113333333333333333333331311331313113133331131311113333331113331111111111111
121111111111111111212121112111211122111111111111211111111112111111211111112111111111111111111111111111121111111111211111111221111121111112112111111211
111111111121111111111111121111111121111111111111211111211111211111121111111121111111211111111111111112112111112111111111112111111111111211111111111111
111111111121112112121111112211121112121111111111111121211112112111111111112111111111111112111112111111111211111211121111111112121111111112111111121112
122111111111111111111121111221111111121111211111111111111121111111111112111111111111111112111111112121111111111111212111121111111112111111111112111211
112111112111111111121211111111111121111111222111211111112112111121111211112111211111111111111111111111111111111111111121221211111111111111111111111111
111111111111111111111111211111121111111121112112211111111111112111121111111112111111111211111121111111111111121111111111111111111111111111111111121111
211111111111121112112211111111111121111111211111111111111111111111111111211111211111111111112111121111121111121111111111111111111121111111111111111121
112121111111121111212111111111212112121111111111111111111111111111111211111111111111112111111112111112111111111112111111212211122112121111111112111111
111111121111211111111111211211111211211121111212111111111222111112111111111111111112111111112112111121112111112112111211121111111111111111111111111111
111111111111211221211111122111111111111212211211111121111111111111211111111111111111111121111111112122111111211111121111111111211111211111111211111212
111112121111111111111222111211121111211112212111111111111112111111211111211111111111111111111211111112111111111111111111121111122111112111212111111111
111111111111111111111111121111111112211111122111111111111211112121111121122212111111111111111111111111111211121112111111121112121111111111111111111111
112111112211211211211111111111111112111111121121111111111111111111111111121111111111212211111121111111111111212211111111111111212111111111111111111121
211211211111111111111111211111111212111111111111121112121121222111111111111122111111111111121111112111111111111111111111111111111111122111121121221111
111121111111112221111121111111112111222111111111111111111111111111111121121111211111111111111111112111111211111111111112111111111112111111111211111111
111111211111111211111121111111111121111111121111111111112111111122111111111111111111111211111111211211111112212111211111211121111111211111221121111111
121111112212111111121121111111111111111111121211111211111211111112111111112111121111111211112111121111111111111111112111121111121211111111222111111111
111111111111111121112112111111111111111111211212121111111112111111111111111211121111111111111111112211211112111111112111111111112111112121111111111121
111111111111111111111121111111111111111121111111121111111112111111111111112111111111112111111111112112111211111211111111121121211111111211111112111211
111111112111111212211111111111121111111111111111111212112121211111112111111121111111111111122111111111121111111111111111111111111111111112112111211111
111111112111111111112111111112111111111111111111122111111111111112211111111211111112111111111111121111112111111111112111121111211211111211111111112111
211121211111111111111211111111111211111111111211111111121112111111122121111111121111111111111111111111111112111111121111111211111211111111211111111111
111111111122212111111111211111111121111212121122211111111112111111111111211111111111121111111111211111111111121111111111111112111111112111112111111111
111111111121112111111112111111222111122111111211111111111111112111111121111111122112111111111121111211112121121111111111111111111211111121111211111211
211111211111111112211121111111111111211112121111111121111111111121111111112211111211111121111111121111111111121211111112111111111111111111111111121111
111111111111111111121111111111111111111111111121111111111111111111111121112211111112111121111121111111112121111111111111111111111112111111221111211111
111122112111111111111221111211111211112111111111111111112111111111221111121111112111121211111211111212111111111111112111111111111111111111111111111111
111111111111211111111111111112111111111111111111111112111111121111111111111111111112111111111111111211112111111111121111111112111111111111111111111111
111111121111121211111111121111211111111112111111112111111111111111111111112111111121111111211211111121111111121111111121111111211111111111111111111111
111112111111111112111222111112111111112111111111111211111111122111112111211111111111111111111111111112111111111111111111111111111122111111111121111111
121111121112111211111112212111111111121111211121111121121112111111111111111111121111111111112111111111121111111111111112122111111111111111111111121111
111121111111111211111121112211111111111111111211112111111112111121112111111111111111111111111111111111111111221111111111111111111112111211111111111111
111111111122112111122111111111112111212111111111111112221112112111221111111111111111111121112111221111111111111211111111122112112111111112111111121112
111111111111111112111111111111111111111112111111121111111111111111112111121121121111112111121112111111212111112111111121111121111111211111111112111111
211111112111111211111111111111111111211111112111111111111111211111111111111111111111111111121112121111111111111111111111111112111221111111212111111111
111111221111111212111111221121121211111111112121121111112111111211211111111211112111112111111111111111111111111111211111112111111111211111112121112111
111111111111112111121111111111111121111111111111121111111111211111111111111211112111111111111111121112111111111111111211121121112111121112211111111111
112111111211122111121111111111111111111111121111112111111111211211121112111111112211111111111211121211111211112111111112111111111111121211111112111111
111111111111111111122111111111111111111112111111111111111112111111111111111211112111211111111111111111112111111211112111211121111111211121111111111111
121111211111112111111211111211221111121112111122212111111121111121121211121111111111111112111221111121111111112121111111121121121111122111111211111121
211112211111212111111211122121111111122121111112112111211111111111111111111111122111112111111111112111121121111111112111211112111111121111111111221111
111121111111121111111211121111211111111121111111111112111111111111111112121121111111112121121111111111112111211111121212112111111111211111212111111111
111112111111111122111121121221211111111211111221211111122121111111111111111112121111211111111111121112112121112111111111211111112111111112111111211111
111111211111111111212211111111121111111121111111111111111212111111111111111121111111121121111111111111111121112112112111111111111211111111111112121111
111111111112111112111211111111221211111111111111111121111111111111211111111111111111111111111121112111111121221121111111111111111111111111111111121111
111211111111111121111111111111111111111111121121111111111221111112111111111111111112111111111111111111111111121111111211112112111111111211212221111111
111111111211111111111221111111111111111111111112211111111111111111111111111111111112211112121112111111212111111122111111111211111111211111111111111112
111111112111121111121211121111111111211111111111111122121111111111111111111111111111111121111211211112111111111111211111111111111111111111222111111111
111111111121111121121111111211111211211111111111121111111111111112121111121121111221111111111111112111111111111111112111111112111111111112111111111111
111112121112111112111111111111111122111211111111112112121211111111111111211111121111121111111221122111112111111111111111111111112111111121211111112111
112121111111111211111111112121111111111111121111111111121112111211111111111111111111121111111111111111111111121111111111111111111111111111111111111111
111111111111122111112111111211111111111111221121112111112211111111212111111111121112122211111111212122111121112111111111111112111112112211111211112112
111111111221111111111111111121111111212112111111111211111111111221111221111122111111211111111111111111111111111211111111211111212211112111121112111121
111111111111121211212211111111112111111112221111111111111111111211111111122111111111111111112211111112111112111222111111111111122111112111112111111111
121111121111111112211121111111111111211211112111111112121111111111111121111211221111111112111111111121211111111111211111122121111111111111111122111111
211111112111211121112112111112111111111211111121212111112111111111111111211111111111111211121211111111112121111111111121121111111112111111111111111111
111122111111111112111111111212111221121111111111111111112111111111111111211112211111111121111111211112111121211111121221121211112111111111111111121111
221112211111111111111112112111121111121211111111111111211121111211111112111111111121111211121111111111111112111111112111112111111111111121111111221111
111111211111111111111111112211111111111111211111111122111111112111111121112121111111111111211111121111121122111111111111111111111111111111111211121111
121121112121111111211111121212111112111111111111111121111111111121111111121211111111111111111221111111111111111111111111211111211112121111111111111112
111111111111111111112111211211111111111112111111121111111111111211111221111111111111212111111121111111111111111111111111111111111111122211212111111112
111111111111121111211111111111111111111111112111111111111111111111121211111111112111121121111111111111112111112111111111211111212111111111111112111111
211111111121111111111112111111111221111112111211121121121111111111211211111111111111211111111111111121111111121211111111111111111111111111111111221112
111111121111121112111111211112111112111121111111111111111111111112222111111112111111111111111111111111112111111211121111111111111111111112111111121111
111111112111111121111111111111211111122111121111211122111112111111111111112121111111111211111211111111112112211111212112212112121122111111111111111111
111111111111111111111112111111111121112211111111112211111111121111111112111112111111211221111211122111211121111112111111111112111111121111112111211111
112111111111111111112111221111111111111111111111111111121111112111111112211111111111221111111111111111121222111121111111111112111111111112111111121111
211111111211111122111111111111211121111211111112121111111212121111111111111111111111111111111111111111121112111111111111111111211111111111111111111111
112111111112111111111111111121111121111111111111111111111112111211111112111111111111111111111211111111111111111111211211211111121111111112211112111111
111111111111112111112111211111111112111211121111112111111111111112121211112111111111111221111111211111111111112111111112111111111111111111111112111111
212211111211111111122112111112112111111111111121111111111121111111111112112211112111121112111111111111121111111112111221111111112111211111111211111111
111211111111111111111111111111111111111111211111111111211111112111211111111111112121121122111111111211111111111111111111112111111111111112111111111211
111111111111111121111111111111121111111111111111111111111211111111111111111111211111111121221211111112111111112111111112111112111122111111111112111112
111211111111211111111211111111111111112121111221211112211111111111111111111111111111111121211111111211112111112211211112111111111111111112111111111112
211111111111122111111111111112111111111112211111111121111111112112111111111121211112111211111112212111111111111112111121121112121111111111111111112111
121111111111111111111112111111121111111112111112111111111211112111211112111111111111111111211111111111121121111111111212111111111111211121111211111112
111111111111211111112111112111121111112111111111111111111111121111111112111111112122111211111111111121211112111112111112211212121121111111111121112111
211111121112111112111112121111111111111111112111111111111111211211111121111111211111112111111111112112112211211121111112111111111111111111111111111111
111111111111111111111121111111111112111111111121112111111122111112111111111111211111112111112221111111121112111111111111111111211111111211111111111111
211112121121111111112211111111222222112111112111211111111111111111111111111111111111211111112111221111111211211211111111111111111111111211111111111111
111112111212111111111111111111112111211121211211111111111211111111111111111111111111211211211111111111211111112111111111111111111112111111111111121111
111111111111111111211111111111111111111211121111111111111111111111111111121111111111111111112212111111111111221121111112122111121111111111111111211111
111111121122111111111112111121111112111111111111111111111121111111111111111112111111111112111121211112111111111111111111111111111111211111211111111111
111111211111211111111112111111111111111211111211111121111111111211111111111111111111111111211111112111211111111111111121111121111111111221111111122211
221111112112121111111111111111111112111112111112111121121111111111111112111111112111121111112111121121111111212111111111111211112121111111111111111111
111111121111111111111111111121211111111111111112121111112111111111111121121211111111111111211111211121122111111111111111111111111111111111111111112211
111111221211111111212111112111111111111111111112111212111111111111111121111111111111111111112111111111211111112111111111111111112111111211111111121211
121111111111111111111112111112111111111212111112111111111111111111112111111111111212121211111111111111121111111211121112111121111211111111111211112111
111112111111111211111111111211211111111222111111111111112211112122211111111211111211211111111112111221111111111112121111111211111111111121112111111111