000000000000000000000000000000000000000000000000000000000000000000000000000000000000000000000000000000000000000000000000000000000000000000000000000000
000000000000000000000000000000000000000000000000000000000000000000000000000000000000000000000000000000000000000000000000000000000000000000000000000000
000000000000000000000000000000000000000000000000000000000000000000000000000000000000000000000000000000000000000000000000000000000000000000000000000000
000000000000000000000000000000000000000000000000000000000000000000000000000000000000000000000000000000000000000000000000000000000000000000000000000000
000000000000000000000000000000000000000000000000000000000000000000000000000000000000000000000000000000000000000000000000000000000000000000000000000000
000000000000000000000000000000000000000000000000000000000000000000000000000000000000000000000000000000000000000000000000000000000000000000000000000000
000000000000000000000000000000000000000000000000000000000000000000000000000000000000000000000000000000000000000000000000000000000000000000000000000000
000000000000000000000000000000000000000000000000000000000000000000000000000000000000000000000000000000000000000000000000000000000000000000000000000000
000000000000000000000000000000000000000000000000000000000000000000000000000000000000000000000000000000000000000000000000000000000000000000000000000000
000000000000000000000000000000000000000000000000000000000000000000000000000000000000000000000000000000000000000000000000000000000000000000000000000000
000000000000000000000000000000000000000000000000000000000000000000000000000000000000000000000000000000000000000000000000000000000000000000000000000000
000000000000000000000000000000000000000000000000000000000000000000000000000000000000000000000000000000000000000000000000000000000000000000000000000000
000000000000000000000000000000000000000000000000000000000000000000000000000000000000000000000000000000000000000000000000000000000000000000000000000000
000000000000000000000000000000000000000000000000000000000000000000000000000000000000000000000000000000000000000000000000000000000000000000000000000000
000000000000000000000000000000000000000000000000000000000000000000000000000000000000000000000000000000000000000000000000000000000000000000000000000000
000000000000000000000000000000000000000000000000000000000000000000000000000000000000000000000000000000000000000000000000000000000000000000000000000000
000000000000000000000000000000000000000000000000000000000000000000000000000000000000000000000000000000000000000000000000000000000000000000000000000000
000000000000000000000000000000000000000000000000000000000000000000000000000000000000000000000000000000000000000000000000000000000000000000000000000000
000000000000000000000000000000000000000000000000000000000000000000000000000000000000000000000000000000000000000000000000000000000000000000000000000000
000000000000000000000000000000000000000000000000000000000000000000000000000000000000000000000000000000000000000000000000000000000000000000000000000000
000000000000000000000000000000000000000000000000000000000000000000000000000000000000000000000000000000000000000000000000000000000000000000000000000000
000000000000000000000000000000000000000000000000000000000000000000000000000000000000000000000000000000000000000000000000000000000000000000000000000000
000000000000000000000000000000000000000000000000000000000000000000000000000000000000000000000000000000000000000000000000000000000000000000000000000000
000000000000000000000000000000000000000000000000000000000000000000000000000000000000000000000000000000000000000000000000000000000000000000000000000000
000000000000000000000000000000000000000000000000000000000000000000000000000000000000000000000000000000000000000000000000000000000000000000000000000000
000000000000000000000000000000000000000000000000000000000000000000000000000000000000000000000000000000000000000000000000000000000000000000000000000000
000000000000000000000000000000000000000000000000000000000000000000000000000000000000000000000000000000000000000000000000000000000000000000000000000000
000000000000000000000000000000000000000000000000000000000000000000000000000000000000000000000000000000000000000000000000000000000000000000000000000000
000000000000000000000000000000000000000000000000000000000000000000000000000000000000000000000000000000000000000000000000000000000000000000000000000000
000000000000000000000000000000000000000000000000000000000000000000000000000000000000000000000000000000000000000000000000000000000000000000000000000000
000000000000000000000000000000000000000000000000000000000000000000000000000900000000000000000000000000000000000000000000000000000000000000000000000000
000000000000000000000000000000000000000000000000000000000000000000000000000000000000000000000000000000000000000000000000000000000000000000000000000000
000000000000000000000000000000000000000000000000000000000000000000000000000000000000000000000000000000000000000000000000000000000000000000000000000000
000000000000000000000000000000000000000000000000000000000000000000000000000000000000000000000000000000000000000000000000000000000000000000000000000000
000000000000000000000000000000000000000000000000000000000000000000000000000000000000000000000000000000000000000000000000000000000000000000000000000000
000000000000000000000000000000000000000000000000000000000000000000000000000000000000000000000000000000000000000000000000000000000000000000000000000000
000000000000000000000000000000000000000000000000000000000000000000000000000000000000000000000000000000000000000000000000000000000000000000000000000000
000000000000000000000000000000000000000000000000000000000000000000000000000000000000000000000000000000000000000000000000000000000000000000000000000000
000000000000000000000000000000000000000000000000000000000000000000000000000000000000000000000000000000000000000000000000000000000000000000000000000000
000000000000000000000000000000000000000000000000000000000000000000000000000000000000000000000000000000000000000000000000000000000000000000000000000000
000000000000000000000000000000000000000000000000000000000000000000000000000000000000000000000000000000000000000000000000000000000000000000000000000000
000000000000000000000000000000000000000000000000000000000000000000000000000000000000000000000000000000000000000000000000000000000000000000000000000000
000030000000000000000000000000000000000000000000000000000000000000000000000000000000000000000000000000000000000000000000000000000000000000000000000000
000313000000000000000000000000000000000000000000000000000000000000000000000000000000000000000000000000000000000000000000000000000000000000000000000000
000111000000000000000000000000000000000000000000000000000000000000000000000000000000000000000000000000000000000000000000000000000000000000000000000000
303111300000000000000000000000000000000000000000000000000000000000000000000000000000000000000000000000000000000000000000000000000000000000000000000000
101111100000000000000000000000000000000000000000000000000000000000000000000000000000000000000000000000000000000000000000000000000000000000000000000000
131111133000000000000000000000000000000000000000000000000000000000000000000000000000000000000000000000000000000000000000000000000000000000000000000000
111111111000000000000000000000000000000000000000000000000000000000000000000000000000000000000000000000000000000000000000000000000000000000000000000000
111111111000000000000000000000000000000000000000000000000000000000000000000000000000000000000000000000000000000000000000000000000000000000000000000000
111111111330000000000000000000000000000000000000000000000000000000000000000000000000000000000000000000000000000000000000000000000000000000000000000000
111111111110000000000000000000000000000000000000000000000000000000000000000000000000000000000000000000000000000000000000000000000000000000000000000000
111111111110000000000000000000000000000000000333000000000000000000000000000000000000000000000000000000000000000000000000000000000000000000000000000000
111111111113000000000000000000000000000000303111333000000000000000000000000000000000000000000000000000000000000000000000000000000000000000000000000000
111111111111300000000000000000000000000000131111111000000000000000000000000000000000000000000000000000000000000000000000000000000000000000000000000000
111111111111100000000000000000000000000003111111111300000000000000000000000000000000000000000000000000000000000000003000000000000000000000000000000000
111111111111130000000000000000000000030001111111111100000030000000000000000000000000003300330030333300000000000000001000000000000000000000000000000000
111111111111113300000000000300000000310031111111111130000010300330000000000000000000001103113013111100000000000000031033000000000000330000033000000000
111111111111111100000003033130300000110011111111111110000313103110003330030000003030031101111311111103000000000000311311033000000000110003311030000000
111111111111111103000001011110103003113311111111111110003111101110001113013333001310011131111111111131000000033000111111011300000003113001111310000003
111111111111111131333331311113131331111111111111111113331111131113331111311111331113311111111111111111333333311333111111311133333331111331111113333331
111121111111111122111111111211211211111121111111111111112211221111211111211211111121221211111111111121111121121112111111112111111111111111111121111111
111111111111211111112121111111111111111111111111111211211111211212111121111121121111111122112111111111111111122111111111211111111111111111111111111111
111111111111111121211211112111111121111111111111211112111111111111111112121111121111111111111111211111111111121211111111211221111111221111121111111111
121122111121111121121211111111111111111111111111111111111211211111111111111121111111111111121111111111111111111212111211111111121111111111111111222111
111111111211121121111121111111111111111111111111111111111111111111121121111111112111111211112111211111111111111211111111111111111112111111111111111111
111111111211111121111111111111111111121111111211211211111111111111111111211111111121211121111112111112211111111111111121111111111212121111211111111111
211111111111111111211111211111111111111111111121111111211112212112121211111111111111112122111121111111111111111111121111111111111211111111111111111122
111211111111111111121111111111112121111211111111111111111111112111121111112111211111111111111111111111111111111111111211111111111111111111111111111121
122111111111111112111212112111111111111111111111111111111111111111111111112111111111121111112111111221111111111111111111111111211121211111111111111111
112121111111221111111111211121211111111112122111111111111111121111111111111211211111211111111211111112111111211111121111111122111111111111111212111111
121111211111111111211111111111111211121111222111111111111111111211111111111111111211111111121112111111111211111111111111111111212111112111121111111111
111111111121111112121111111111111111111111111111111111111111111111111121111111111111211111111111111111111111121111221121211111112111111121112121111121
221121121221111121111211122111111111121121111111122111111121111112111121111211111111221111221111111111111111111111121111111111111121211111111111111111
111111111111211111111111111211111211122111111111221121111111112111222111121121111111111111111211111111111111111111111111111111111121111111111111111211
111111211211122111211111111211112111122111111111211221112211112111111111111111211211211112111111211112111112111111111111111111111121111111121112111111
111111121111111111121111121211111111111121112121111121112111111211211111111111111111111111111111111111111112221111111211211111111112111111111211111111
111111111111111111111111112112211121111111111111111111121111111111112111111121111211111111111111121111111112221121111111111111112111112121111112111111
121211111111111211111111111111112111111111111111111111111111121121111111111111111121111121112211111111111111111111111111111121111111111111111111111111
121112111111111111111111121111111111111111111111111111111112121111112111211212111111121121111111111211112111111111112111111111111111111112111111111121
122111121111112111111111111121111121112111111111112121111121112112111111111111111111111111111111111111111111211211111112111111111111121121111111111111
111121111111111112111112111121211111111111111112111122111111111111111111221111111211111111222111111111111111111111112111111121111111111221111111111111
111111111111111211111111121111111111111111121111121111121111121111111111111112111111111111211121121111111121111112111221112111212212111111111111121111
111111111112111112111112112111111111111111121111111112111111111121111111121111121211111111112111112111111111111121111112211111111111111111111111112111
112111111111111111111111112111111121111111111111111111111111111121111121111111111121111111111111211212111111111111211112111111112111121111211111111111
111112121221121111121121111112121221111111111111111121111111111111111112121111221111121111111111111112111111111111212122121111111111111111221111111111
111111212111121111111111212112111121122111111121111111111111111211111111111112111111111112111111111121111121111111121111111111112121111211111211211111
111111111211112111111111112112111112111111111111111111111112121112122111112122111111111121111111111111111111111111112112112111111111111121111111111211
111111121111112111111211111121111211112112111111111111111111111111111112211111111112111121111111111211211111121111122111111111121111111111111111111121
111111111111112111111111111211111111111211111111111111221221111111111111112111112111111111111121111111111111111111111112111111111111111111111111111111
112221221111111122121211111211111211111111211112212111111111112111111111111121111112111111221211111111111111222121111111212112111121111111221111121121
111111111111211112111111111121111111111111111211112111111111111111221121121111111121111111112111111111111111111111121211111111111111111111211121111111
111112111111121121121121111111111121111111111111111211111111111111111111111112111211111111111112111121111121112111121111211111111111111112111111121121
112111211111112111121111111111111111111111211111112112111111111221111111121111211111121111111111111111111111111112111211111121111211111112111111212111
121111111111111111112121111111111111111221111111221112111111111112111111111111111111111111111111112211221111112111111121111112111111211111112111111121
111111111112111122111212111121111111121111111111111111121111111212111111211211111221111111221211211111111111111122111111111111121111111112211111111111
211111111111112111111111111211211111111111111111111111111111111111111121211111111112111111112111211111111111111111111111111111111111111211111111111122
111111111111111211111111111111112111112111111111211111111121112211111211221111111112111121111211111121111211111111111211112111111211111111211111112111
111111111121111121111112111211111111111111111111212111111111111111122112111111211111111111111111111111111111122111111111111111112111111111111111111112
111111111111111121122111111121111211111122111212111211121122112112221111111111111111111111111111111111111111111211111111212111111111111112111111111111
121112111211111111111111111212111111112211111111111112111111111111111111111121112111111211111111111111111122112111111111112111111112112111111111111122
111111111111111111112111111211112111111111211111111111112112111111111112111112111111112211111112111211111111121112111111111111111111111121111111111121
122111111111111211111111121111111111211111111111122111111112112111111111112111111121211111111111211111111111111221121121111111111111111111111111111111
112111112111211111112111111112111122112111111111111111112111111111121111112112111111121121111112111111111111111112111111112111111111111111111112111111
121111111111111112111111111111111111111111121111211121221111211111121112112111111121112121111211111111111111111111211111111211211111111111111111211111
211112111111111121121111111111112111111111111111112111221111111111111111111111111111111111111111111111111111111111111111211111111112111111211111211111
111211121212111121111111111112122111212122111111111111111112121121211111111121111111111211121221111221111111112111111111111111121112121111111121111111
111111122111111121111111111211111111211111212111111111112111111112111112111211111111112112112111111112211211111111112111111111211111112112121111111111
111111111111112111121112121111121111111121111112111121112111111111111111111112211211111111111111111112221111111111111111111111111111111111111111111111
111121111112111111111111111111111111111221111111111211112111111111111121111211211111111111111111111111112111211111121211111111112111111112211111121111
111211111111211111111111211111111111111211111112111121111111112111111121111111211111111111111112211111111121111221112111111111111211111111111111121111
111111121111111122111211111111111111111111111111111122111211111111111111112111111111111111111111121111111112111111111112111111111111111111221211111111
111111111111111111111221111111111111111111111111112111111111211112122111111211211111111111111111112111111211121111111112121211211111111221111112211211
111112211111121211211111111111111111111112111211112211111111111111112111111111111111111111112111111211111111111111111111211111121211111111111111112111
111121111111111111112111112111211111121111111111111121111111121112111211111211111121221111111121111111111111111111111111111111212222111111111111111111
111111111111111111111122111121111111112111111112121111111111112111112111112111111111111111111111111111111111111111221111111111111111211111111111211121
111111111111111121122111112111122111111111111111111111122211211111121111122111211121121111111111122112111111111211211221121111221111121111111211211111
111111211112111212211112112111111111111111111111111111111112111111111111111111221111121111111211112112111111111111111111121121121111111111111111211111
111111211111211111111121112111111111111121111111111111111112211112112111111121111111111112211111111111111111112111111111111111111111111111112111111112
111111111111111111112112111211111111111111121111111111111111111111121111111121111111111111121111111211111211111211111111112111111121211111111111111111
112121111121111121111111111121111111211111212111212111111221111111112111111121111111211211111111211111111211121211111121111111111211111211121111211211
111111111112111111111211111112111211111111111111111112111211111112121111111111111111111111111211221111111111111221111111121111111111111211111111121111
111111111111112112111111111111111111111111111111111111111111221211111121111111111111121111111111111111112211221111211111121112111112111111211112121111
111111111121111111111111121111112111111111211111211121122111111111111112111111111212111111111111111121121112121111211211121111112111111211111211111111
121121111111111111121111111121111111111112111121112111111121111111111111211111111111212111111111111111111121211122111111111111211111212111111111111111
111111111221221111111112111212111111111111111111111121111121111211111111111111221111211111112111112111111112111111111112111111111211112211111111111112
112111211111111111211111112111211112111111211111111111112211111111111111111112111111111111111111111121111111121111112111121111111112111111211111111111
111111211111111211211211211111111111111211211112111121111111111121211111111111121111111212111111111111111112121222111111112111111111111112111111111111
112111111111111111111211121112211112111111111111111111111111111111111121111111122111211111212111111111111111111111111121111111122111111221221111211121
111111111211111111111111111112111112112111211111111121211111111112112211112211121121111111111111111111212111111111111111111211111112111111111111111211
111111111111111112111112111111111112111111211111111121111111111211111111112111221111121111112111111121121211111121111111111211111111221111211111111211
111111121111111111211111111111111111111111111111111112111111211111111112111211111112111111111111111111211211111111121211111121111111111111111111111111
111121111121211111111111111111111111111211112111111111111121211111122121111111112111111111211211211111111111111122221121211111111111211111111111111111
111111221111111111111111111111122111111111111111111111111111111121111111111211111111111111111111111111111111221111111211111111211111111112121111111111
111112111111111211121211111121111121111111111111211111111112111111211111121111221111122111121111211111111212111111111221111121121111111221121111111111
111111111111121111111112121212111112112111112111111111212111111111111111111111112111112111111111211111211111111121121111111111111111112111111211111111
211111111111111211111112211111111111111112112111111121111111212121211111111111111111111111111111111111111111111121112111212121111111111111111211111111
111121211121111112111111211111111211111111111112111111111111111111111111121111111111112111111111112111111111111111111211111111121111111121111111111111
111111112111211121111111211111111111112111111112111211211121111211111111111111111111112111122111111111111111221112112111111211111111111111221111121111
211111111111111112211111112111111111111112121111211111121211112112111111211111111121121211111111211111111211112111111112112111111111111221111121112121
111111111111121111111111111111111111111111111111111111111111211111111121111211211112121211121111121211112211211211111111111111111111111111111111221111
211111111111121211121111121111121111121112111111111111111111111111111122212112121111111111111111111111111111111111211111111122121111111111121111111111
111211111112112112121111112111111111111221111111111111112111111111111111121211111121111111111121211111111111121112211121111111111111111111111111111111
121112111111111112211111212111112121111111111111112111211111211121112111111121111111111112211111111121112111111211111122111111112112111111112111111121
111111211111111111111121111111111111111111111112111121111111111121111111111111111112111111111111111212111121111121112111111111111111111111112211121111
111112111111211111111111111111111111112211111111111111122111111111111111111111111211111111111111111111111112212111111111111211111121111111111111111111
211111111111211221211212112111211121111111121221111111111111211112111111221111111111111111111111111111111111111111111121211111111121121121211111111111
122112111111111112221111111111111111111112111211111211111111111111111111111112111112111111111121111112111111211111111111111111111111121121111121111111
112211111111111111111111111111112111111122111122221112111111111211111111111111211111111111111111111111121111111121111111211221111111121111111111111121
111111111211111111112111111111111111211221111111111112112111111111111111112111211111111121111111111111111111121111111111111111111121111111212211112111