000000000000000000000000000000000000000000000000000000000000000000000000000000000000000000000000000000000000000000000000000000000000000000000000000000
000000000000000000000000000000000000000000000000000000000000000000000000000000000000000000000000000000000000000000000000000000000000000000000000000000
000000000000000000000000000000000000000000000000000000000000000000000000000000000000000000000000000000000000000000000000000000000000000000000000000000
000000000000000000000000000000000000000000000000000000000000000000000000000000000000000000000000000000000000000000000000000000000000000000000000000000
000000000000000000000000000000000000000000000000000000000000000000000000000000000000000000000000000000000000000000000000000000000000000000000000000000
000000000000000000000000000000000000000000000000000000000000000000000000000000000000000000000000000000000000000000000000000000000000000000000000000000
000000000000000000000000000000000000000000000000000000000000000000000000000000000000000000000000000000000000000000000000000000000000000000000000000000
000000000000000000000000000000000000000000000000000000000000000000000000000000000000000000000000000000000000000000000000000000000000000000000000000000
000000000000000000000000000000000000000000000000000000000000000000000000000000000000000000000000000000000000000000000000000000000000000000000000000000
000000000000000000000000000000000000000000000000000000000000000000000000000000000000000000000000000000000000000000000000000000000000000000000000000000
000000000000000000000000000000000000000000000000000000000000000000000000000000000000000000000000000000000000000000000000000000000000000000000000000000
000000000000000000000000000000000000000000000000000000000000000000000000000000000000000000000000000000000000000000000000000000000000000000000000000000
000000000000000000000000000000000000000000000000000000000000000000000000000000000000000000000000000000000000000000000000000000000000000000000000000000
000000000000000000000000000000000000000000000000000000000000000000000000000000000000000000000000000000000000000000000000000000000000000000000000000000
000000000000000000000000000000000000000000000000000000000000000000000000000000000000000000000000000000000000000000000000000000000000000000000000000000
000000000000000000000000000000000000000000000000000000000000000000000000000000000000000000000000000000000000000000000000000000000000000000000000000000
000000000000000000000000000000000000000000000000000000000000000000000000000000000000000000000000000000000000000000000000000000000000000000000000000000
000000000000000000000000000000000000000000000000000000000000000000000000000000000000000000000000000000000000000000000000000000000000000000000000000000
000000000000000000000000000000000000000000000000000000000000000000000000000000000000000000000000000000000000000000000000000000000000000000000000000000
000000000000000000000000000000000000000000000000000000000000000000000000000000000000000000000000000000000000000000000000000000000000000000000000000000
000000000000000000000000000000000000000000000000000000000000000000000000000000000000000000000000000000000000000000000000000000000000000000000000000000
000000000000000000000000000000000000000000000000000000000000000000000000000000000000000000000000000000000000000000000000000000000000000000000000000000
000000000000000000000000000000000000000000000000000000000000000000000000000000000000000000000000000000000000000000000000000000000000000000000000000000
000000000000000000000000000000000000000000000000000000000000000000000000000000000000000000000000000000000000000000000000000000000000000000000000000000
000000000000000000000000000000000000000000000000000000000000000000000000000000000000000000000000000000000000000000000000000000000000000000000000000000
000000000000000000000000000000000000000000000000000000000000000000000000000000000000000000000000000000000000000000000000000000000000000000000000000000
000000000000000000000000000000000000000000000000000000000000000000000000000000000000000000000000000000000000000000000000000000000000000000000000000000
000000000000000000000000000000000000000000000000000000000000000000000000000000000000000000000000000000000000000000000000000000000000000000000000000000
000000000000000000000000000000000000000000000000000000000000000000000000000000000000000000000000000000000000000000000000000000000000000000000000000000
000000000000000000000000000000000000000000000000000000000000000000000000000000000000000000000000000000000000000000000000000000000000000000000000000000
000000000000000000000000000000000000000000000000000000000000000000000000000900000000000000000000000000000000000000000000000000000000000000000000000000
000000000000000000000000000000000000000000000000000000000000000000000000000000000000000000000000000000000000000000000000000000000000000000000000000000
000000000000000000000000000000000000000000000000000000000000000000000000000000000000000000000000000000000000000000000000000000000000000000000000000000
000000000000000000000000000000000000000000000000000000000000000000000000000000000000000000000000000000000000000000000000000000000000000000000000000000
000000000000000000000000000000000000000000000000000000000000000000000000000000000000000000000000000000000000000000000000000000000000000000000000000000
000000000000000000000000000000000000000000000000000000000000000000000000000000000000000000000000000000000000000000000000000000000000000000000000000000
000000000000000000000000000000000000000000000000000000000000000000000000000000000000000000000000000000000000000000000000000000000000000000000000000000
000000000000000000000000000000000000000000000003000000000000000000000000000000000000000000000000000000000000000000000000000000000000000000000000000000
000000000000000000000000000000000000000000003301300000000000000000000000000000000000000000000000000000000000000000000000000000000000000000000000000000
000000000000000000000000000000000000000000031131100000000000000000000000000000000000000000000000000000000000000000000000000000000000000000000000000000
000000000000000000000000000000000000000030311111133000000000000000000000000000000000000000000000000000000000000000000000000000000000000000000000000000
000000030000000000000000000000000000000013111111111300000000000000000000000000000000000000000000000000000000000000000000000000000000000000000000000000
003300013000000000000000000000000000000311111111111100000000000000000000000000000000000000000000000000000000000000000000000000000000000000000000000000
001100311000000000000000000000000003030111111111111130000000000000000000000000000000000000000000000000000000000000000000000000000000000000000000000000
031100111030300000000000000000000001013111111111111110000000000000000000000000000000000000000000000000000000000000000000000000000000000000000000000000
311133111313100000000000000000000031311111111111111110000000000000000000000000000000000000000000000000000000000000000000000000000000000000000000000000
111111111111100000000000000000003011111111111111111113000000000000000000000000000000000000000000000000000000000000000000000000000000000000000000000000
111111111111130000000000003000001311111111111111111111003000000000000000000000000000000000000000000000000000000000000000000000000000000000000000000000
111111111111113300000000001000031111111111111111111111331000000000000000000000000000000000000000000000000000000000000000000000000000000000000000000000
111111111111111100030000031300011111111111111111111111111000000000000000000000000000000000000000000000000000000000000000000000000000000000000000000000
111111111111111100310300011100311111111111111111111111111300000000000000000000000000000000000000000000000000000000000000000000000000000000000000000000
111111111111111130110133311130111111111111111111111111111130000000000000000000000000000000000000000000000000000000000000000000000000000000000000000000
111111111111111113113111111113111111111111111111111111111110000000000000000000000000000000000000000000000000000000000000000000000000000000000000000000
111111111111111111111111111111111111111111111111111111111110303000000000000000000000000000000000000000000000000000000000000000000000000000000000000000
111111111111111111111111111111111111111111111111111111111113101000000000000000000300000000000000000000000000000000000000000000000000000000000000000000
111111111111111111111111111111111111111111111111111111111111131303003300000000000130000000000000000000000000000000000000000000000000000000000000000000
111111111111111111111111111111111111111111111111111111111111111101031103030000033110000000000000000000000000000000000000000000000000000000000000000000
111111111111111111111111111111111111111111111111111111111111111131011131013030011113300000000000300000000300000003030000000000000000000000000000033000
111111111111111111111111111111111111111111111111111111111111111111311111311010311111130030000000103000333103003031310000000003300000000000000003011300
111111111111111111111111111111111111111111111111111111111111111111111111111313111111113310000303131030111101331011110003000001100300000300300031311100
111111111111111111111111111111111111111111111111111111111111111111111111111111111111111113333131111313111131111311113331333331133133333133133311111133
111211121121111111111111121111111111211221111111111111211211121111121111111112111211111111111111111111111211211112111111112111111111111211111111211111
211111211111112111111111211211211111112221111111111111111111111111121211111111111122112112111112121112111111121111111111111122111112111111111111111211
121111111111111111111121111111221111111111111211121121111112111121112112111111211211111111111121111111211211211211121112111111111112111111111111111111
111111211111111111111221211111121111111111121121211112211211111111211121111111111112111111111111111111211211111112111121112111112211111111111111111211
121111111211111111111111121111111112111111111112111111111111111111111112111111211111111111111111111111111111121111111221211121111121221211111111121112
222112111111211121111211111211111211112121112111111111211111111112111112111111212111111111111111111111211211111111111111111111211111111111111121111121
111111112111211111112111111111122111111111211111112121112111111111111111121111111111122112121121111111121111111111111211111111121112111212121211111111
211121111112121111111211111111111111212212121111111112111121111221111121111111111112111111112221121111111111111111111111111111112112111111111111121111
111111111111111121112111111112112111111121111121111211111111211211111111111111111111111111111211111111121121211111111111111111111111111111111111112111
111112111221121112111111111112111111111111111121111111121211121111111111111211111111111112111111111121121111111111121111111111111112112111111111111111
121121111211121111111111211121112111111111111121111111111111121111111112111112111121221112112111111111111112111111111121111111111111112111111111112111
111111111122111111111111111111121121221111111111111111111211111111111211111111211111111111111112211111121211111111111111112111111112121111111121111111
111111111111111111111111111112111111211121111112111111111121111111121111111112111111111111111111111111111121111111111111122111111111211111111111111111
111111111111212111111111111121111111111112111111111121112111111111111111121111111111111111111112111211111111111112111121112111211211111211111111112121
111111111112211111111111111121111112111111111111111122111111111221111111111111111111111121111111111111111111111112111112111111111211121111211111111111
111111111111112112111111111111111211111111111111111111211111111111111111121111111111111111112111111111121111112111111111221121111111111111112111112211
111111111111121111111111111111111111111111111111111111111111111121111112111111111112122111111111111211112111111111112111111121111111111111222211111111
111111111111111111111111111111122211111111121111111211111211211111121111121121111111111111112111111111112111111111111112121112111111211111111111111111
111112211111111111111111211111111112122111121111122111111111111111111111211111111112111111111111211111111111111211111212111221112111111111111111111212
111112111112111111211112111122121211111121111111111111111122111111112112111111111111111111112111111122111111111112111211111122121111121111111112111111
111111111121111111211111111111111111111112121111211111111211111111111111111211111112111111111111111112111111111111111111121111121111111111111111111111
111111111212112111111111111111111112111111111211111111112111111121111111121111111111111111111112111111211121111111111111111121111121111111111111212111
111121111211111111112111111111111111111111111111111221111111111111111111111121111111111111121212112111121111211111111121111111111111112121111111111111
111111111112112111111111121111111111111111111112111211111111112111211211221121121222111111211211211121111111121112121111111111111112111111111111111111
111111112111212111111111111111111121112111122111112111121111111111111111111111111121112211121211111121111111112111112111111111111211111112111112122121
111112211111111221111121111111111111122111111111111111111211111111121112111111211111112111111111212111111111111111121111121111111111111111111111111111
111112111111121111111111111112111112111111111111111111111111112111111111111111111111111122111121211111111211111111212111111111211211111121111121112111
121111211211111111112111111111111121111111211111111111111112111112111211111111111111111111111112211111121112111121111111111111111111111211111111111121
211111111111111211211111211111211111221211111111111111111111111211111111121111121111111111111121111111111111111121111111111121112211111111111111111112
211121121111111211111111111111111112111111111111111111111221211121111111111212111111111111211111111111121121111111111111111211111111111111111111111111
112111111111111111112211111111111111111211111211111111111111111111111111111111111111111211211111111111121111112122111111111111211111121111111112111122
111111121111111111122121111111111121111111211111112111121111111111121111112111111111111111211111111111121111111111111121111111111111111121111121111111
111111111111212111111111111111121111112111112111112111111111111121111111111112111211111111121111112111111111221111211112211121111111111111111111111112
111111111111111221121111111211111111111111211111112111111212121121111111111111111111112111111111111111111111112111111112121121111211111112121111112121
211121111111111111211111111111111212111121211111111112112111111111111111111111111111111111111111111211111111121111111111111111111112111111122111111111
111111221111111121111112111111112111111111111211111111211111111211111111111112112111112111211111211111112111111112111111111111111111111112112212111111
211121111121111111111111111111111111111111111111111111211111111111111111111111112111112111111121211111121112111111111122111111111121111111121122111111
121111121111111211212121111111111111111112211121111111111111111121121111111111212111111211111122212111111111121111111211221111111111111111111111111111
111111111121111111211111111111211111111112111211111111111111121111111121111111111212112121111111211111111111121122111111111111111221111111121211112211
111111111111111111111121111211112111111221112111111211111111221112121111112111111111111111111111111211121111111111111111111111111121111111111221121111
121121211111211111111211111111112111111111111111111111111111111111211121112211111121121211111121111111112111111111111121111111111111212111111112111112
111121111121112211111111211111221112122111221111121111111111111111112111111111111111111111111211121111111111211111111111122111111111112111221211111111
111111211111211111121111111211111111111121111111111111121111111111111112111111111111111111211111111121111111111121212211111111121111121111111111111112
111111111111111111111111111211111111111111121111111111111211211111111211111221212111111111111111111111111121111211111122112111111211111112111111112111
112121111111111111111121111111121111121112111111111111111121121111121111111111111112111211111111211111111111111112111111111111212111111111111111111111
111111112111111111212111121121111211111111111111111211121121211111111111212111111112111111111111212221211112122111111111111111111121211112211111112111
111121111111211111111111112111111111111111111112111111112111111111111111111111111111112111121111111111111111111111111112111111121212111221111121121111
111121211211112111121111111111111122111111111111111111212111111111112221111121211111111211111111111121111212111111121111111111211111111211121111112122
211111112111121112211111111121122111111111122111111122111111121112111112111111111111111111112111112112211121111211111211211111111112221111111111211111
111111111111111111111111111111111121111121111211111111111111112211111121111111111121111111111111111111111111111111211111211111111111111111111111111222
221111121111111111111111111121111111111112111121111111112121111111112111221111112111111111121111112111111111111111111111111111111111112112111112211111
211111111111121111111111111111111111111111112121111111121112111111111111121111111111111121111111111111111111111111111112211211111121111111111111211112
111111111111221211111221122111211111111111111111111211111112111211111221111111112112111112111111111111211112111111111111111112111111211111111211111111
111111111121211111111111111111111111111111111112121111111111111111211121111222112211211111111211111111111111111111111111111111111111111111111111211111
111111111111121112111111111111111111111111111211111111111111211111211111111111111111112111112111111111112111211121111111112111111111111111121121111211
111111221111111111112121112111112121111111111111111111111111211111111111111211211121111121111211111111211111111111111111111121121111111112111111111112
111111211111111111111112121121111111121112111121111111211112111121111111111111211121212122111111111112111111111111111111111112111111111111111111111111
112111112111111122112211112111122111111112112111111111121111111111111111111111111211111111111111211221111221121111121111121112111111211111121112112121
211121111111111121111111111111111111111111221111221211111211211121111111122111211111111111111112111111111111111121111111111211211112211122112111111111
121111111111122112111111111121121111121111111111111111111111111121111111111111111111221111211111111111211111121111211112111112111112111111112111111111
121111111111111111211111111111121111121211111111111111111211111111111121121111121121121111111111111111111111121111112112111111111111111111111111112111
112111111111121111111112111111121121111121111111112121211111111111111111111111111212121211111111111111112111111211111111111211111111112112112111112111
211121111111111111111111122111121112111111111111111111111111111111111211111111211111121111211112211121111111111111112111111111211111111111111111112111
111111111211112111111111111111112111111111121111111112111111111121122111111112211111111221111111111112111111112111111111111111221111111111111111111111
111112111112111112111111111111111111112111111212111111111111111211111111111112111111111111111111111112111111112112112111121111211111111111112111111111
111111221211111111111111112121111111111121111211111111111112211111111111121111211112111121111111111111211121111111111111111112211211211121111111111111
212111111121111111111111111112111111211111111111111211111112111121112111121111111121111111211112111111111211112111111111111111111221211111111111111211
112121111121211111112121121111111112112211121111111121111111112112111212121111112112111111112111121111111111211112111111121211211112111111111111111211
111111211111111111111111112112111111111111211111211111212112112111111111111121211111111111211111112112111121111122111111112111111111111121121112111111
211211111111112111111111111122211111121111111111111111111111111111111111111111111111111111111111111112111111111111111111111111111211111111121221111111
211112111111111111112111111111111211212111121112121111111111121111111111111111211121111111221111111222211211121211111121111211111111121112111211111211
111111111111111111111221111111122111111211111211111111121121111111121111121112112111111111222111111121111212111112111112112111112211111111121111111111
112111111111111111111111111121111111111111112212211112111111112111111111111121111111112111111111111111111111111112111111111111221111211111121111111111
211111111111111112112111111121211111112112111121211111111121111211111111111121111111211112111112121111121211211121111211111111111111111112112111111111
111111111112111112111111111111111111111112111111112111111111111111111111211111111111221121112212121111111111111111111111111111111111111111111111111111
211111111111121111121111111112111121111111211112111111211111111111111111112112112111111122111111121111111111111121122111111111121211211121121111212112
111111111111222111111112111112111111111111111111111111111111121111112111121111221111111111121111111111211121111111111111111111111111111122111111111121
211111211111111112111111111111112111111111111111112121112211121111122111111121121212112111111121111112112111111111111112111111222111111111111111111211
111121111111111111111121121111111111112111111111211111221111112111111112111121111122111111111212111211111111222211111211111121111111111111111211111111
111211111211112112211111211111121111111211111112111111121111112111111111112111211121111211121111121211111211111112111111111111111211211111111112111111
221111111111111211111112111111112111111111211111111221121112121111112111111111111121111111111211111111121111111211111111121111111111111121211111111111
221111111111112112211111111111111111111111211121111111112211111111111212111211111211111111111211111121211111112111112211211111111111111112121111111121
121211111111211111112111111111111121111111122111121111121111111111111111211111111111112111111111111111111111111112111211111121111111111111111111111111
112111111211112111111211111111111121111111121112111111121111211111111121121111111111112111111211111111211111111111211212111111111111111112111121211111
211111111111211111121111111111111111111111111111212111111111121111111112111211121111111211121112221111111121111111111111111211111111111111211211111111
111111111211111111111111211221111111111111111111111111211121211111111111122111111111121211111111111112111111111111111111111111111111111111111111111122
112111121221111211111111112111111111111111111111121111211211111111111112111121111121112111111111111111111111111121121111112111111111121111121121211111
121111111111111111121121111211111211111111111111121111112111111112111211111112111111111111112111211111211111112111111121112121111211111211111111211111
112111111111111111111111111211111111111112211111121111211111111111111111121111111111212111112111111111111111111111211111111112111211111112111111211111