000000000000000000000000000000000000000000000000000000000000000000000000000000000000000000000000000000000000000000000000000000000000000000000000000000
000000000000000000000000000000000000000000000000000000000000000000000000000000000000000000000000000000000000000000000000000000000000000000000000000000
000000000000000000000000000000000000000000000000000000000000000000000000000000000000000000000000000000000000000000000000000000000000000000000000000000
000000000000000000000000000000000000000000000000000000000000000000000000000000000000000000000000000000000000000000000000000000000000000000000000000000
000000000000000000000000000000000000000000000000000000000000000000000000000000000000000000000000000000000000000000000000000000000000000000000000000000
000000000000000000000000000000000000000000000000000000000000000000000000000000000000000000000000000000000000000000000000000000000000000000000000000000
000000000000000000000000000000000000000000000000000000000000000000000000000000000000000000000000000000000000000000000000000000000000000000000000000000
000000000000000000000000000000000000000000000000000000000000000000000000000000000000000000000000000000000000000000000000000000000000000000000000000000
000000000000000000000000000000000000000000000000000000000000000000000000000000000000000000000000000000000000000000000000000000000000000000000000000000
000000000000000000000000000000000000000000000000000000000000000000000000000000000000000000000000000000000000000000000000000000000000000000000000000000
000000000000000000000000000000000000000000000000000000000000000000000000000000000000000000000000000000000000000000000000000000000000000000000000000000
000000000000000000000000000000000000000000000000000000000000000000000000000000000000000000000000000000000000000000000000000000000000000000000000000000
000000000000000000000000000000000000000000000000000000000000000000000000000000000000000000000000000000000000000000000000000000000000000000000000000000
000000000000000000000000000000000000000000000000000000000000000000000000000000000000000000000000000000000000000000000000000000000000000000000000000000
000000000000000000000000000000000000000000000000000000000000000000000000000000000000000000000000000000000000000000000000000000000000000000000000000000
000000000000000000000000000000000000000000000000000000000000000000000000000000000000000000000000000000000000000000000000000000000000000000000000000000
000000000000000000000000000000000000000000000000000000000000000000000000000000000000000000000000000000000000000000000000000000000000000000000000000000
000000000000000000000000000000000000000000000000000000000000000000000000000000000000000000000000000000000000000000000000000000000000000000000000000000
000000000000000000000000000000000000000000000000000000000000000000000000000000000000000000000000000000000000000000000000000000000000000000000000000000
000000000000000000000000000000000000000000000000000000000000000000000000000000000000000000000000000000000000000000000000000000000000000000000000000000
000000000000000000000000000000000000000000000000000000000000000000000000000000000000000000000000000000000000000000000000000000000000000000000000000000
000000000000000000000000000000000000000000000000000000000000000000000000000000000000000000000000000000000000000000000000000000000000000000000000000000
000000000000000000000000000000000000000000000000000000000000000000000000000000000000000000000000000000000000000000000000000000000000000000000000000000
000000000000000000000000000000000000000000000000000000000000000000000000000000000000000000000000000000000000000000000000000000000000000000000000000000
000000000000000000000000000000000000000000000000000000000000000000000000000000000000000000000000000000000000000000000000000000000000000000000000000000
000000000000000000000000000000000000000000000000000000000000000000000000000000000000000000000000000000000000000000000000000000000000000000000000000000
000000000000000000000000000000000000000000000000000000000000000000000000000000000000000000000000000000000000000000000000000000000000000000000000000000
000000000000000000000000000000000000000000000000000000000000000000000000000000000000000000000000000000000000000000000000000000000000000000000000000000
000000000000000000000000000000000000000000000000000000000000000000000000000000000000000000000000000000000000000000000000000000000000000000000000000000
000000000000000000000000000000000000000000000000000000000000000000000000000000000000000000000000000000000000000000000000000000000000000000000000000000
000000000000000000000000000000000000000000000000000000000000000000000000000900000000000000000000000000000000000000000000000000000000000000000000000000
000000000000000000000000000000000000000000000000000000000000000000000000000000000000000000000000000000000000000000000000000000000000000000000000000000
000000000000000000000000000000000000000000000000000000000000000000000000000000000000000000000000000000000000000000000000000000000000000000000000000000
000000000000000000000000000000000000000000000000000000000000000000000000000000000000000000000000000000000000000000000000000000000000000000000000000000
000000000000000000000000000000000000000000000000000000000000000000000000000000000000000000000000000000000000000000000000000000000000000000000000000000
000000000000000000000000000000000000000000000000000000000000000000000000000000000000000000000000000000000000000000000000000000000000000000000000000000
000000000000000000000000000000000000000000000000000000000000000000000000000000000000000000000000000000000000000000000000000000000000000000000000000000
000000000000000000000000000000000000000000000000000000000000000000000000000000000000000000000000000000000000000000000000000000000000000000000000000000
000000000000000000000000000000000000000000000000000000000000000000000000000000000000000000000000000000000000000000000000000000000000000000000000000000
000000000000000000000000000000000000000000000000000000000000000000000000000000000000000000000000000000000000000000000000000000000000000000000000000000
000000000000000000000000000000000000000000000000000000000000000000000000000000000000000000000000000000000000000000000000000000000000000000000000000000
000000000000000000000000000000000000000000000000000000000000000000000000000000000000000000000000000000000000000000000000000000000000000000000000000000
000000000000000000000000000000000000000000000000000000000000000000000000000000000000000000000000000000000000000000000000000000000000000000000000000000
000000000000000000000000000000000000000000000000000000000000000000000000000000000000000000000000000000000000000000000000000000000000000000000000000000
000000000000000000000000000000000000000000000000000000000000000000000000000000000000000000000000000000000000000000000000000000000000000000000000000000
300000000000000000000000000000000000000000000000000000000000000000000000000000000000000000000000000000000000000000000000000000000000000000000000000000
100000000000000000000000000000000000000000000000000000000000000000000000000000000000000000000000000000000000000000000000000000000000000000000000000000
103000000000000000000000000000000000000000000000000000000000000000000000000000000000000000000000000000000000000000000000000000000000000000000000000000
131003330000000000000000000000000000000000000000000000000000000000000000000000000000000000000000000000000000000000000000000000000000000000000000000000
111001110000000000000000000000000000000000000000000000000000000000030030000000000000000000000000000000000000000000000000000000000000000000000000000000
111331110000000000000000000000000000000000000000000000000000000000310013300000000000000000000000000000000000000000000000000000000000000000000000000000
111111113300000000000000000000000000000000000000000000000000000033113311100000000000000000000000000000000000000000000000000000000000000000000000000000
111111111100000000000000000000000000000000000000000000000000000011111111130000000000000000000000000000000000000000000000000000000000000000000000000000
111111111100000300000000000000000000000000000000000003000300000311111111113000000000000000000000000000000000000000000000000000000000000000000000000000
111111111133303100000000000000000000300000000000000301300100000111111111111300000000000000000000000000000000300003000000000000000000000000000000000000
111111111111101130000000000000000000103000000000000131103133303111111111111100000000000000000000000000000003100301300000000000000000000000000000000000
111111111111131110000000000000000033101000000000003111131111101111111111111100000000000000000000000000033031100131100000000000000000000000000000000003
111111111111111110000000000000000011131000000000031111111111131111111111111130003000000000000000000000011311133111100000000000000000000000000000000001
111111111111111113000000000000030311111303030000011111111111111111111111111110031000000300000003000330311111111111130003033003000003000000000000030031
111111111111111111000000300000013111111131013000311111111111111111111111111110011300000100030331000110111111111111110001311301000001000000030000010011
111111111111111111333333133333311111111111311333111111111111111111111111111113311133333133313111333113111111111111113331111131333331333333313333313311
112111111111112112111111111111211111121111111111111111111111122111121111111212111111111211121111212122211111111111112122111111111111121111111111211112
211112111211111111111111111121112111121111121111112111111111111112111111111211222112111111111111111111111121111211111111121111111111111212111111111111
112121111111111211111122111112111111111111221211111111111211212111111111111121111111211111111121111112211111121111211111111121221111111111111111121111
111111111211112112211211122121111111111111211112221111111111111111111111111111211112211121111111111111111111111122111111111111211121111111111211111111
111111111111111112111111111112111111111211111121111111111211111111121111112111111121111221111221111111111112111111112111111111121111111212111111111111
111112111121111111212111121121111211111111112111211221111211111111111212112112111111111211111121111121121111121111121111111211111111111111111211112111
111112121111111121111111111111111111112111111111112121111112111111111111112211111111121112111211111111112111112211111111112111121112111112112121111111
111111111111111221111211111111111111112111111211211211111111111112121211111111211111111111111112111112111111111111112111111111121111121112112111112211
111111111211111112111112111211111211111111111111111111111111111121111211111111111211111111111111111111211111111122221211111111211211111211111111211111
211111111211111111111112111111111111111111111111121111111211111111111111121111111121112111111211111111111111122111121111121111111111122221111211211111
111111111111121111111121111121111111112111111111111111111111111211111112211121111112111111111211121111111111121211111111111111111111111111111211211111
111111111111111121111111121111111111112111111111111111111211111211111121111111221121112111111111112111111121122111121112111111111111111111112111221111
112111112211111211111111121111111111111121111111111211111211111111111121211122121111112211111211212112111111111111111121111111111121112121111111112111
121212111111111111211111111121112111111112211111111111211111111111121111211111212111112111111111112111111111111112121112111111111111111121121111112111
111121111112121111111111121112111111121111111111111111111111111111111111111211111111111111111111111111211111111111111111111111211212111112111111111111
111121111121111111111111111112111111111111111111111111111111111111111111111111111111111121111111112211111111111111112211111121211111111111111111111112
211211121111111121111111111111111111121111111121112121111121111111111111211111111111111111212121111111121111111211111111111111111112111111111111111211
111111112111111111121111111111111111111111111111111111221111221111112111111111212111111111111111111112111111112211111121112111111111111111111111111111
112111111121121111211121211112111221111112111112111111112111121111211111111121111111111111111111111212111111111111111121111111111111111111111211111111
111111111111111111112111111111121111211111111121111111121112111111122112111211211121111111111111121111111111111111111111111111111111111111111211112121
111111211111112112121211111111111111111111111111211111111111111111111111211111111211111211111211112111111111212111121111111111111111211221111111111111
121111111111212121111112121111212111111111111121121111111111211111111111111221111111111121111211211111111221111111111111111111112111111111111111211111
111211111111111112111112111111111111111111112111112111111111111211112111111111111111111111111111111111111111111112111112121111111211112111112112111111
121112111111111111111111111111121111111111111111111211111111212121111111111111111111111111121111111122111112121111111111111111111111112111111111111211
111111111111111111211111111211122211112111111221111111111212211112111121111112111121111111121111111111111111111111111111221221111111111211111222111111
111111112111111111111111111111111121111111111112111111111111111121111211211111111111111111111121111111111211111121111111211121112111212111112111111111
112111111111111121111111111111111112121111111111121111111111111111111111111111112111121121111111111111111112122111111111111212111111111111111111111111
111111111111111112212111211111111111112111111211111111111121111111111111111111111111112111112111111111111111111111211111111111222111111112121211112211
211111121122111111111111111111121111211121111111111111121211111111121111212211111111211111111111111121111111212111111122111111121111211111111211111111
121121111111111111111111211111112111122111112211121111211121121112111111111111211111111121111111111121121111111111111122112111111111122111211112211111
111211111211111111111111111111111111122111111111112111111111111111112111111212112111111111111112111111211111111211111111221111111221111111112111111111
111111111211111121221112111111111111111111111111111111111112111111112111111111111111211112111111121111111111111112111111111121111112211112111211112111
111111211121122211121111112111221111111112111211111111112111112111112111211112111112221111111111111111211111111112111112211111111112111211122112121112
112111111211121111111211111111111112111111111211111122111111211111111111111111112111111111111111111111111111121121111111112111211111111112111111111111
111111111111112122112111112111111112211211111111211122111121211111111111121111111111111111212111111111111122111211111112111211111111211211211111111111
111112211111111111121111111111111111111211111111111111111111112111211111111112112111111111111111112111111112111211111111121111111111211111111111112111
111111112111111111111112121111111211112111111111111111111111111111111111112112111121112111122111112111111111111122112121111111211121111111111111111111
111111111111111111111111221111111121211111111111111111111121211121211111111121221111111111111111111121121211111111211111111111211111121111111122111111
111111211111111212111111111111211111111111111112121111111211111111211111211111111122112121111111111211111111111121111111111112212111111112111111111111
211112112121111111111111211112221111111111111222121111121111111111111111111111111211111111121121112112211112111111111111111111111211111112111111111112
111112111111122211111112111211111121111111111111121112111211121111111111121111111111111121111111112111111111121111111221112112211111211111111211111121
111121111211111111111111111111111211111111111111111121211211111121111111112112111111111121111121111211112111111111121111111111111112211111111122111111
111111211111121111122111211111111111111211111111111211112121111111112211211211111111111111112121111111111111121121111111211111111111112111211111111121
111111111121111111111111111112211111211211111111111111112111111112111111212112111111111221111111111111111111121111211111111111111111211111111111111111
111112111111121112111111121111211121211111111121122211112211111121111211111111111111121111221111111112111121111111112111111111211111111112111111111111
211121111121111111211111121111111111111111111111111112112111111111111111111111111121211111111121211111111111211111111111111111111111111111111121111211
122111111111111111111111111111111111111111111112121111112111121111111111111111211111112111111121112111121121211121112111111111111112111111111111111111
111111111111111111111111112111111111121121111111111111211111111112121111212111112111111111111121121111112111111111111111111211111111112121111121111111
111121111111221111111111111121111112112111111111111111111111111112212121211111211111111211111221112111121112111121111111111111111111121112111111111112
111111111112111121211121111211111111111111112111112111111212111111111111111112121111112111111111111211111211211111111121121111111211211111211111111111
121211111111111211111111212112111211111111121111111111111221111112111111221221111111212111111111111112112111111111111121121211121111121111211111111121
121121111111111111221121111121121121111111111111112111111112111111111111121121111111211111111111111111111111111111111111111211111111112121111111121111
111111111211111112112111111111111121111212111111111111211111121211111121111211112111111221111112122111112211111121111111111111111112111121111121111121
111111111111111111122111111111111111111111111111111112111211111112111111111122111111111111111111111111111112211111111111111112111211111111112121111111
221121111111111122111121111111112111121111112121121111111111111111121111111111111111111112111121211111112121111211112111111111111112112122111111111112
111111121211111112121111111111111121111111112111111111121121121111111111111112111112121111111111222121211111111121111111111111111111221111111121111111
111111211112111121112112121111111111111111111111111121111111111122111111211112111111111121211111111111111112112111111121121112112121111111111112211121
111111111112111211112111111111111111112111112111111121111111111112222111211111111121111111111111111211111111121211111111121111111121111112111111111112
111211112111121211211211122112111111111111121111111111111121211111121111111111111111111111121121111111111111112111112122111211111111112121111111211111
111211111121122111111211111111121111112111111111221111121211111111111111112111211111111111121122112111121212111111122111111111121221221112121111111111
112111111111111111111111111111111121111111211111211111111111112111111111211111111112111122111221112211111121111111111111112111111111112111111111112111
111111111111112121121111111111111111112121121111211112111111121112111111111121111111211111111111111111111111111111111111111111121111111212111111111111
111111111111111111112111111211111121111111111111121111111111112111121111112111211111111111112111121111111111111111112112121111111112211211111111111112
111111111211111111111111211111111111111121112111111111211111111121111111211211211112111111111121112211111111111112121111111112111111111111111111211111
111111111111111111112111211111211111111111211111111111111111111111111111111111111112211111111111111111111122111111111111111121112111121111211111111111
111121111112211111111111121111111121111121112221111112111111121112212111122111111211121111211111111111112111111121111111111111111111111111112211111111
111111111111121112121211121111111122221211121111111211111111211111212111211112211111111111111111111112212111211121111111121111112112111111111111111111
121111121122111111221121111111211111222111112111211121111121111111111111211211111111121211111111121111111111111111111121111111111111211111111222111111
111111111211111111111111211111122211111111211111121211211221111211111211121111112111211112111111111212112121111111111112111111121211112111112112111111
211111121111111111111211121111211121111112111211112111211111211111122111111111111111111111111111221111111111112111111112111111111111111111122111211211
111111111111122111211112111111211112111111111111111121111112111111111112111121111111221111111111221111111111112111211111121111111111111111111111111112
111111121111111211111111221111121112111111111111111112111121111121111211111111211211211112111121112111112111112211112111111212112211221111121112121111
111111111112111112211111111122111112111111211111111111111111111111111111111111111111111111221121111111111111111111111111111111211111111112111121111111
111111111111111111211121111111111112111111111111111112111111111111111111111111111111212211211111111211112111121111111112111112111112111112111122111211
111111111111111111121112111111211111111111111111121111111112111111111111211121111211112111112211211111221111212111111121111111111111211111111111111111
111112211111111112112121111221122111111111121111111111111121121111211111111111111121121111111111111111211121211111111111211111111111111111211112111111
111111111111211221111111111111111111211111121111112111112112112111112111111211111111111111111221121111112112111121111111111111111111212121121111212111
212211221111111121111111211111121111112111211111111111111112111121211111111111111112111111111111111121211111111111111111111121211212111111111111212111
211211111111111111112211111111111111211111111111211211111121112111111111111111111121121111211112111111111111111111111111111111211212111111111111111111
221112111111111121111111111111111211111111111211111111112111111122111111111211111121111121111211111111211111121121111111111111111111111211111111111112
111111121112111211111211121111111121111111121111111111111111211112112211111112211111211111211111111111111111111111111111111111111111121111111211111111
111111211111111211111111111111111111111112211112111211111111111111111111111121211111111111111111111111111111121111211111112111111122112111111111122111
112111122211111111111111111121111111111211111111111111112211111111111212111111111111121111112121121111112111211111111211122112211211221211211111112111
211221111211111111111111112111111111212111111111212111111111111111111111111111111111111111111111111111111111111111111111111111121111111111211111111111
112111112122111111121211111111111121121111111111111122111211111111111111111111121111111111111111112112111211112121111112211111111111111111111111111111
211112121112111111211111112111122211121111111121211111111111111211111111111111112112112111211112111111121111111112111111111111111111111211111111111121
111111212121111211112111111211212111112111111111111121111111111111111112121211211112112111111121111211112111111111111121111111211112122111121111111111
211111111111112111121111221212121111211112111111111111111211111121111111111211111111121111111111112111111211211111111111122111111111211211111111221112
112212111111121111111212111111211111111111111121111111211111112111111111111111111211111111111111111111121111111111122111111112111211211111111121111111