000000000000000000000000000000000000000000000000000000000000000000000000000000000000000000000000000000000000000000000000000000000000000000000000000000
000000000000000000000000000000000000000000000000000000000000000000000000000000000000000000000000000000000000000000000000000000000000000000000000000000
000000000000000000000000000000000000000000000000000000000000000000000000000000000000000000000000000000000000000000000000000000000000000000000000000000
000000000000000000000000000000000000000000000000000000000000000000000000000000000000000000000000000000000000000000000000000000000000000000000000000000
000000000000000000000000000000000000000000000000000000000000000000000000000000000000000000000000000000000000000000000000000000000000000000000000000000
000000000000000000000000000000000000000000000000000000000000000000000000000000000000000000000000000000000000000000000000000000000000000000000000000000
000000000000000000000000000000000000000000000000000000000000000000000000000000000000000000000000000000000000000000000000000000000000000000000000000000
000000000000000000000000000000000000000000000000000000000000000000000000000000000000000000000000000000000000000000000000000000000000000000000000000000
000000000000000000000000000000000000000000000000000000000000000000000000000000000000000000000000000000000000000000000000000000000000000000000000000000
000000000000000000000000000000000000000000000000000000000000000000000000000000000000000000000000000000000000000000000000000000000000000000000000000000
000000000000000000000000000000000000000000000000000000000000000000000000000000000000000000000000000000000000000000000000000000000000000000000000000000
000000000000000000000000000000000000000000000000000000000000000000000000000000000000000000000000000000000000000000000000000000000000000000000000000000
000000000000000000000000000000000000000000000000000000000000000000000000000000000000000000000000000000000000000000000000000000000000000000000000000000
000000000000000000000000000000000000000000000000000000000000000000000000000000000000000000000000000000000000000000000000000000000000000000000000000000
000000000000000000000000000000000000000000000000000000000000000000000000000000000000000000000000000000000000000000000000000000000000000000000000000000
000000000000000000000000000000000000000000000000000000000000000000000000000000000000000000000000000000000000000000000000000000000000000000000000000000
000000000000000000000000000000000000000000000000000000000000000000000000000000000000000000000000000000000000000000000000000000000000000000000000000000
000000000000000000000000000000000000000000000000000000000000000000000000000000000000000000000000000000000000000000000000000000000000000000000000000000
000000000000000000000000000000000000000000000000000000000000000000000000000000000000000000000000000000000000000000000000000000000000000000000000000000
000000000000000000000000000000000000000000000000000000000000000000000000000000000000000000000000000000000000000000000000000000000000000000000000000000
000000000000000000000000000000000000000000000000000000000000000000000000000000000000000000000000000000000000000000000000000000000000000000000000000000
000000000000000000000000000000000000000000000000000000000000000000000000000000000000000000000000000000000000000000000000000000000000000000000000000000
000000000000000000000000000000000000000000000000000000000000000000000000000000000000000000000000000000000000000000000000000000000000000000000000000000
000000000000000000000000000000000000000000000000000000000000000000000000000000000000000000000000000000000000000000000000000000000000000000000000000000
000000000000000000000000000000000000000000000000000000000000000000000000000000000000000000000000000000000000000000000000000000000000000000000000000000
000000000000000000000000000000000000000000000000000000000000000000000000000000000000000000000000000000000000000000000000000000000000000000000000000000
000000000000000000000000000000000000000000000000000000000000000000000000000000000000000000000000000000000000000000000000000000000000000000000000000000
000000000000000000000000000000000000000000000000000000000000000000000000000000000000000000000000000000000000000000000000000000000000000000000000000000
000000000000000000000000000000000000000000000000000000000000000000000000000000000000000000000000000000000000000000000000000000000000000000000000000000
000000000000000000000000000000000000000000000000000000000000000000000000000000000000000000000000000000000000000000000000000000000000000000000000000000
000000000000000000000000000000000000000000000000000000000000000000000000000900000000000000000000000000000000000000000000000000000000000000000000000000
000000000000000000000000000000000000000000000000000000000000000000000000000000000000000000000000000000000000000000000000000000000000000000000000000000
000000000000000000000000000000000000000000000000000000000000000000000000000000000000000000000000000000000000000000000000000000000000000000000000000000
000000000000000000000000000000000000000000000000000000000000000000000000000000000000000000000000000000000000000000000000000000000000000000000000000000
000000000000000000000000000000000000000000000000000000000000000000000000000000000000000000000000000000000000000000000000000000000000000000000000000000
000000000000000000000000000000000000000000000000000000000000000000000000000000000000000000000000000000000000000000000000000000000000000000000000000000
000000000000000000000000000000000000000000000000000000000000000000000000000000000000000000000000000000000000000000000000000000000000000000000000000000
000000000000000000000000000000000000000000000000000000000000000000000000000000000000000000000000000000000000000000000000000000000000000000000000000000
000000000000000000000000000000000000000000000000000000000000000000000000000000000000000000000000000000000000000000000000000000000000000000000000000000
000000000000000000000000000000000000000000000000000000000000000000000000000000000000000000000000000000000000000000000000000000000000000000000000000000
000000000000000000000000000000000000000000000000000000000000000000000000000000000000000000000000000000000000000000000000000000000000000000000000000000
000000000000000000000000000000000000000000000000000000000000000000000000000000000000000000000000000000000000000000000000000000000000000000000000000000
000000000000000000000000000000000000000000000000000000000000000000000000000000000000000000000000000000000000000000000000000000000000000000000000000000
030000000000000000000000000000000000000000000000000000000000000000000000000000000000000000000000000000000000000000000000000000000000000000000000000000
010000000000000000000300000000000000000000000000000000000000000000000000000000000000000000000000000000000000000000000000000000000000000000000000000000
310303000300000000003100000000000000000000000000000000000000000000000000000000000000000000000000000000000000000000000000000000000000000000000000000000
113131330100000000001100000000000000000000000000000000000000000000000000000000000000000000000000000000000000000000000000000000000000000000000000000000
111111113100000300031130000000000000000000000000000000000000000000000000000000000000000000000000000000000000000000000000000000000000000000000000000000
111111111130300100011110000000000000000000000000000000000000000000000000000000000000000000000000000000000000000000000000000000000000000000000000000000
111111111110103103311110000000000000000000000000000000000000000000000000000000000000000000000000000000000000000000000000000000000000000000000000000000
111111111113101131111113000000000000000000000000000000000000000000000000000000000000000000000000000000000000000000000000000000000000000000000000000000
111111111111131111111111000000000000000000000000000000000000000000000000000000000000000000000000000000000000000000000000000000000000000000000000000000
111111111111111111111111000000000000000000000000000000000000000000000000000000000000000000000000000000000000000000000000000000000000000000000000000000
111111111111111111111111300000000000000000000000000003000000000000000000000000000000000000000000000000000000000000000000000000000000000000000000000000
111111111111111111111111100000000000000000000000000001000000000000000000000000000000000300000000000000000000000030000000000000000000000000000000000000
111111111111111111111111100000000000000000000000000031300000000000000000000000000000000130000000000000000000000310003000000000000000030000000000000003
111111111111111111111111130000000000000030000033303311100000000003330000000000000000333110000000000000000000000110301000000000000300310000000000000031
111111111111111111111111110000000030000013030011131111130000000001110000000030000000111113000000000000000003003113131033000003000100113300000000000011
111111111111111111111111110300000010000311010311111111113300000031110000030310000033111111003000000000000031031111111311000331003103111100033030000311
111111111111111111111111113130000310003111313111111111111130000011113000013110003011111111301000300003000011011111111111000111301131111100011010300111
111111111111111111111111111113333113331111111111111111111113333311111333311113331311111111131333133331333311311111111111333111131111111133311313133111
111111112111111212111111112111211111111111111112111111111211111111111112111111211112111111111112111111111211111111111121121111112111112111121111111111
211112111111211111211121111111111112111111111111111111111211111111112112111111121111211111121111111111111121112211122111121111111211121121212211111111
122211111111112121111111111111111111121221111111111121111111112121111212112111111111211111111111112111211111111111111111111211221112111111111121111111
111111111111121111111111112111121111111121111111121111111121111112111111111111111112211211111111112122211111111111112111112111111211112111111111121111
111112111211211111111111111111111111111111111111111211111111211111111121111111111111212211111111111121111111112111211211111111111111111111111111112112
211111111111111111211111111111212111211111111111111111121211121211112111111112111111111211121121111112111111211111122111111111111211122211111111111211
121111112111111111211111111112111111111111111111111212111211111111111211111211111111111112111111111211211111211211111112111111111221111111111111112111
111111111111211111111111111111111111211111121211112121211112111111111111111112111111121122111112121112121111111111111111121111111111111111211111111111
121211111111111112111121111111112121112111211111112111111111111111212111211111111111112111111112111211111111111111111111111121121112111111121111111112
112111111111112111111111111111111111211111111111111112221111111111111111111121111111111211111112111111111111121111111111111111121111211111111111111111
112211221111111111111111111111111111111111111111122112111111111121111111212111111121111112111212111111111211111111112211111111221111111111121111112211
111111111211111211111111111111111111111222111111211211111111111111111111111111111111111112111111111111112111121111111111211111121111111111111111121111
111111111111121112111112111121121111111111111111111111121121111111112111111211121112111111111111112111111221211222111111111111111111111211111112112111
112211111211111121111111211111111111111111111112211111111111111121111111111121111111121211111111222111121111112111111111112111111111111111111111111111
211111111211111111121111211111121211112112111112111211111112111111121212111111112111111212112111111111112111111121111111111111111111211111111111111111
111111211111111111211111111111111111111111111111211111111111221111112111121211111111122112111112111121111121111111112111111111211111111121211111211111
112111112111112111111111111111112111111111111111111111111111111111111111111111212212111121111111211121111112111112111121111111111112111111111111111111
111111211111211111111111121211121111111111111111112111111211111111111111121111111111111111111111112121111111111112111211112211111111111111111111111121
121111112212111211111111211111111122111111122221111112111111111211111111111111111111111111111121111111112111111111111111111112211111111111111211111111
111111211121211111111211111211111121111111111111111111111211221111111111112121111112112111112111111111121111111121111111112111111121111111112111111111
111121121111111111112111121111211121121111111111111111111111211121111111111111111122111112112112111121111121111111111111111111211111111111121111211111
112111111111122111112121111211111111111111111111111111111111111111221111111111211122111112111111111211111121112112122111112211111111211211112121111111
111111111112111111111111112111121112121111111111121111122111111112111221111111111111111111111111111111111112111111111111112121122122111112211111111121
121111111111111111111221121112112111211111112211211112111121122112111111111111111111111111111111111111111111111111111111211122111121111111111121111211
111121111111111111111211111111112111111111111211111211121111111122121211121111211122212111111111111111121111111111111111221222111111212111111111111111
111112111111111111121111211111112212111111211112111211111112111121122111221111111221112111111111121211111111111111111111111111111112111111111211112121
221111111211111111111111111122111111111211111111111111111111112111121111121111111111111111211111121111111111121111211112111111111222111111111221111111
211111111111111111111111121121111111111121112111212111111111111111211121111211211112111112121111111111111121111112112111111111111111111111111121111111
111111111111111111111111111212111211112111111211111111111121111211111111111111111211111121111111111111121111111111112111111111111211111111111112111221
111111111111211112211111112221111211121111111211111212121121111111111111111211111111111111111111111111111111111121112111111121121211111112111212111111
111111111111111111121111111121121111111211111121111111111111121111212111111112111111211111221111221111121111111111121121111111111111121111111111111112
111211111111111121121111211111211111121111111121111111211122211111211111111111111111111111211111111111111111211122111221112111111111111111111111111211
112111111121112111112112211111111121111111211111121111111111112111111111111111111111111111112111112211111111112111111111111111211122111111111111112111
211122111111211211211111111111111111111211112121211212212112111111111211112111111111111111111111111111121111111111212111211111111111112111111111111211
111111111211121211111111211112211111111111121112211122111111111111111122111111111111211111112111111111112211111211111211111121112111121111111111111111
111111111111111112111111111111111222121111211111111112121121111111211111211211111111111121121111111111112111211111111112111111111112111111121111111111
111211111211111111211211111111111121211111121111111122111111211112111212111111111211111111211111111111112211211111121111211111111111111111122112111211
111111211111111211111211111111112111121111211211111111111111111111111111121111112111111111111111111211111111111111111111111112121121111111111111111112
111112111111111111211121111112111121111111121111111111111111211211111111111121211221111111111211111111111122111111112111111121121111111111111111111112
111211121211111112111111121111111211121121111111121112111112111111111111111112121121111111211111111112111211111112111111111111111111111111111111211111
111111121111122111121111111111122111221111111111111111111111211211211111111112111111112111111121111111111211111111111222112111112111111211122211121111
112211111111122111111111111121111112211111121111111222111111111111111111121112111211111111112111211111211111111121212111111111111111121121111211211111
111111111111111111111111111211111111112111111111111111111111111121111111112111111111111111211111111221121111122111112111111111121111111111211112121111
112111211111111111111211111111111211111111211111111111112111211111112122111111111111121111111221112111211211212111211111111111111111121111122111111111
112211111121111111111111111211121112111111121111212111112211111122112111111111111112111211111121112111111111111111111122111121111111111111111111111121
111111111111121111111111211111111111111112121111211111121112111111111111111112121111111111111111111121112111111111111111111111212112111111211111121111
111111111111221111222111111111111111112111111111111111111111212111111112112111111111111211112222111121111212112111121111111111211121112112111111211111
111211211112112221111111112211211111111211111111111111211111212111111111211111211111111111111121111111211111221121111111111111121111211112111111111111
111221111111111112111111111112111111111111111111111111111111111111112111211111111211111111211111111111111111111111112121111221111111121111111121111111
111211211111112112211212111112111111111111111211111111111111112111111122111111121112211111111112122211111111121111112111222111111111111111111111111111
111111111111111112111112212112112111211111111111111111111221111111111111111111111111111211111111111111111111112111111121111111121211111111121121111111
121111111111112111111112121111211121111111122111111111111111111112121111111111111121112112111112111111111121111111111111111111212111111111111111111111
211111111111111111111111111122121211112111111111211111221111111111112111112111111111111211111111121111111112111111121111111121121111111211111111121121
111111211111111111111111112211111112111111111111111111111111121111112111111111111112111111111111111121111111221111111111112111111111111211111111111111
211121111121211121121211111111111111111111111121111121212111121111111111111111111211111111111112211111111111111211111111111111111111121111221112121111
112112111211111211111112111111111111111111111211111111112121111211211111112111211111211111211111111211112121111111111111121111111111111121111212111211
111111122121112111111111111111211112112111111111111111111221111111111111111111111111111111121121111111111111111111111111111111111111111112111111111111
111211111111111111211111111111111111111111111111121121211222111121111111111111111111111111111111111111111121111111111211111221111211112111121111111111
111112121111111112211121121111111111111111111111112121121112211111121111111112111111111121111111111111121111111111121111111111111111111211121111111111
111211121111112111112111111111122121111111211111111111111111121111111212121111121121111111111111111111111111111111212111111111111111111211111112211211
111111112111111111121111111111111111111111112111111111111112111121111111111111111211211111111211111111111111111121211111111111111111112111111112111111
111211111111111111111111111121112111111111211111111111111111111111111111121111121112111111111111121111121111121121121211122111121211112111211111111111
111111111111111112111111111111111111111111112112211111111112111111112111111111111111111111112111111211111111112111111111111111121111112111111211121111
111121212111111211111111112111111211111111111111111111212111111211211111111111111111111211211111111111211111111111111111111111211111211112211112121212
111211111111111111111121111121111111111111111111111111111111121111121111111111111111112111122121111212111111111111211121211111111121111111112111211111
121111111112211111211221111211112121111111111111211111111111111111111111111111212111111111211111122112111121111111112211111111111121111211111121112111
111112212112111111111111111111111212121121211111111111211111111211111121111111111111111211111111112121211111212211211111111111111211111111111121221111
111112111111111211121111121111111111221111112111111111111111111111111111111111111211111111111121111211111111111111111112111111111111111111111112121111
221112221112111111111111111111111111211111111221111111111111111111111111112111112212112111111111111111111211111111111111111111111111111221211112111111
112221111111111111111221111111111111111111111111111111112111111211111111121111111121121111111112221111111221111211121111111111111111111111111111111111
111112111111111121111121111111111112112121211111211111112111111111121122111111111112111111211111111121112111111111111111111111211111111111112121111121
111111112111121111111111111121211111111111111111111111121111111111111111111211111121112121112122121111111111112111122111111111111111121111111211111111
112111111111111122111121111121111111211211111211121111121121111111111111111111111111111111111121111111111211121111111111211112111111111111111111221112
111111111122111211111212111111111111121121112111111111111111111121111112111111111111111111111211111112112112121111112111111111112111111111111211111111
112112111111111111111111111111111111211111111112121111121111111112112111211111211111111111111111111111111111111111111212121112112111111111111211211111
111111211111111121111122211111111111111112111122111211111112111212111121111111111211111111111121121111111111122111111111211111111112211211111221111111
111112111111111111112111112111121111111111221111111111111111111111112111121111111111111111121111111111111111111121111111111111111111111111111111111111
111111111111111111111111112112111111111122111112111111121111121112111111112111121211111111211121111111121111112111111112111111111211111111121111111111
111111111211111111111111211111111112111221111211111111221112211211221111111111211112111112111111111121211112111121211111212121122121111112211121111111
111111111111111111111111112111111111221121111112111111112211111111111111111111111112121111111211111211111212112212111111111111121211111111111111111212
121211111111112111111111111111122221111111221121212111212211111211121111111211111121111112121111121111111121111111121111112111211111111111121111111111
111112111111121211111112111111211211111111111111111111121212121211111111111111111111111111111121111111111111121111111111111111111111111121111211112111
111122221111111111111111221111111111111112121111111111121211112121111121211111121111111111211111111111121111112121111111111111211111111111211112212111
111111212111121111122111111111121111111111211111111111111111111211211111111111121211112111111121112111111111111111111111211111111111111111111111211211
211111112112111112111111111111111111111122111111111111211111111111211111211111111122111121111111111111111111111111111111112111112111111111111111211111
211111111112111111111112121121211111121111111111111111211111121111111111111111112211111111111112211111111111121111121111111111111221112112111111111111
111112111111111112112111112111111111112111112111111111112111111111121111112211211111211111111112211121111121111111111111111112111111111111111211111111
111112121111121211211111111212111111111111111211111111211111122121122111111112122111121211211111211211112111111111121111111111111112212111112111121111
111222211111111111111111111111111211112121111112111111111111111111111112111111111111121111211121111212111211111111111111121122111121111211112211111112