000000000000000000000000000000000000000000000000000000000000000000000000000000000000000000000000000000000000000000000000000000000000000000000000000000
000000000000000000000000000000000000000000000000000000000000000000000000000000000000000000000000000000000000000000000000000000000000000000000000000000
000000000000000000000000000000000000000000000000000000000000000000000000000000000000000000000000000000000000000000000000000000000000000000000000000000
000000000000000000000000000000000000000000000000000000000000000000000000000000000000000000000000000000000000000000000000000000000000000000000000000000
000000000000000000000000000000000000000000000000000000000000000000000000000000000000000000000000000000000000000000000000000000000000000000000000000000
000000000000000000000000000000000000000000000000000000000000000000000000000000000000000000000000000000000000000000000000000000000000000000000000000000
000000000000000000000000000000000000000000000000000000000000000000000000000000000000000000000000000000000000000000000000000000000000000000000000000000
000000000000000000000000000000000000000000000000000000000000000000000000000000000000000000000000000000000000000000000000000000000000000000000000000000
000000000000000000000000000000000000000000000000000000000000000000000000000000000000000000000000000000000000000000000000000000000000000000000000000000
000000000000000000000000000000000000000000000000000000000000000000000000000000000000000000000000000000000000000000000000000000000000000000000000000000
000000000000000000000000000000000000000000000000000000000000000000000000000000000000000000000000000000000000000000000000000000000000000000000000000000
000000000000000000000000000000000000000000000000000000000000000000000000000000000000000000000000000000000000000000000000000000000000000000000000000000
000000000000000000000000000000000000000000000000000000000000000000000000000000000000000000000000000000000000000000000000000000000000000000000000000000
000000000000000000000000000000000000000000000000000000000000000000000000000000000000000000000000000000000000000000000000000000000000000000000000000000
000000000000000000000000000000000000000000000000000000000000000000000000000000000000000000000000000000000000000000000000000000000000000000000000000000
000000000000000000000000000000000000000000000000000000000000000000000000000000000000000000000000000000000000000000000000000000000000000000000000000000
000000000000000000000000000000000000000000000000000000000000000000000000000000000000000000000000000000000000000000000000000000000000000000000000000000
000000000000000000000000000000000000000000000000000000000000000000000000000000000000000000000000000000000000000000000000000000000000000000000000000000
000000000000000000000000000000000000000000000000000000000000000000000000000000000000000000000000000000000000000000000000000000000000000000000000000000
000000000000000000000000000000000000000000000000000000000000000000000000000000000000000000000000000000000000000000000000000000000000000000000000000000
000000000000000000000000000000000000000000000000000000000000000000000000000000000000000000000000000000000000000000000000000000000000000000000000000000
000000000000000000000000000000000000000000000000000000000000000000000000000000000000000000000000000000000000000000000000000000000000000000000000000000
000000000000000000000000000000000000000000000000000000000000000000000000000000000000000000000000000000000000000000000000000000000000000000000000000000
000000000000000000000000000000000000000000000000000000000000000000000000000000000000000000000000000000000000000000000000000000000000000000000000000000
000000000000000000000000000000000000000000000000000000000000000000000000000000000000000000000000000000000000000000000000000000000000000000000000000000
000000000000000000000000000000000000000000000000000000000000000000000000000000000000000000000000000000000000000000000000000000000000000000000000000000
000000000000000000000000000000000000000000000000000000000000000000000000000000000000000000000000000000000000000000000000000000000000000000000000000000
000000000000000000000000000000000000000000000000000000000000000000000000000000000000000000000000000000000000000000000000000000000000000000000000000000
000000000000000000000000000000000000000000000000000000000000000000000000000000000000000000000000000000000000000000000000000000000000000000000000000000
000000000000000000000000000000000000000000000000000000000000000000000000000000000000000000000000000000000000000000000000000000000000000000000000000000
000000000000000000000000000000000000000000000000000000000000000000000000000900000000000000000000000000000000000000000000000000000000000000000000000000
000000000000000000000000000000000000000000000000000000000000000000000000000000000000000000000000000000000000000000000000000000000000000000000000000000
000000000000000000000000000000000000000000000000000000000000000000000000000000000000000000000000000000000000000000000000000000000000000000000000000000
000000000000000000000000000000000000000000000000000000000000000000000000000000000000000000000000000000000000000000000000000000000000000000000000000000
000000000000000000000000000000000000000000000000000000000000000000000000000000000000000000000000000000000000000000000000000000000000000000000000000000
000000000000000000000000000000000000000000000000000000000000000000000000000000000000000000000000000000000000000000000000000000000000000000000000000000
000000000000000000000000000000000000000000000000000000000000000000000000000000000000000000000000000000000000000000000000000000000000000000000000000000
000000000000000000000000000000000000000000000000000000000000000000000000000000000000000000000000000000000000000000000000000000000000000000000000000000
000000000000000000000000000000000000000000000000000000000000000000000000000000000000000000000000000000000000000000000000000000000000000000000000000000
000000000000000000000000000000000000000000000000000000000000000000000000000000000000000000000000000000000000000000000000000000000000000000000000000000
000000000000000000000000000000000000000000000000000000000000000000000000000000000000000000000000000000000000000000000000000000000000000000000000000000
000000000000000000000000000000000000000000000000000000000000000000000000000000000000000000000000000000000000000000000000000000000000000000000000000000
000000000000000000000000000000000000000000000000000000000000000000000000000000000000000000000000000000000000000000000000000000000000000000000000000000
000000000000000000000000000000000000000000000000000000000000000000000000000000000000000000000000000000000000000000000000000000000000000000000000000000
000000000000000000000000000000000000000000000000000000000000000000000000000000000000000000000000000000000000000000000000000000000000000000000000000000
300000000000000000000000000000000000000000000000000000000000000000000000000000000000000000000000000000000000000000000000000000000000000000000000000000
100000000030000000000000000000000000000000000000000000000000000000000000000000000000000000000000000000000000000000000000000000000000000000000000000000
103300000310000000030000000000000000000000000000000000000000000000000000000000000000000000000000000000000000000000000000000000000000000000000000000000
131100300113000030310000000000000000000000000000000000000000000000000000000000000000000000000000000000000000000000000000000000000000000000000000000000
111103133111330010113300000000000000000000000000000000000000000000000000000000000000000000000000000000000000000000000000000000000000000000000000000000
111131111111110313111100000000000000000000000000000000000000000000000000000000000000000000000000000000000000000000000000000000000000000000000000000000
111111111111110111111130000000000000000000000000000000000000000000000000000000000000000000000000000000000000000000000000000000000000000000000000000000
111111111111113111111110000000000000000000000000000000000000000000000000000000000000000000000000000000000000000000000000000000000000000000000000000000
111111111111111111111110000000000000000000000000000000000000000000000000000000000300000000000000000000000000000030000000000000000000000000000000000000
111111111111111111111113300000000000000000000000000000000000000000000000000000003100000000000000000000000000000010000000000000000000000000000000000000
111111111111111111111111130000000000000000000000000000000000000000000300000000001130000000000003000000000000000310000000000000000000000000000000000300
111111111111111111111111110000000000000000000000000000000003000000003130000000031110000000000001300000000000000113000003000000000000000000000000000100
111111111111111111111111110000003000000000000000000000000001000000031113030000011113300300000031100000000000033111000001000000000000000000000000003100
111111111111111111111111113030001030000000000000300030000031000000311111310000311111130100000311130000000000311111003031330000003000000000000000331130
111111111111111111111111111010031010000000000000100010300311303003111111110000111111113130000111110003000030111111301011110000301000000000000000111110
111111111111111111111111111313311313333333333333133313133111131331111111113333111111111113333111113331333313111111131311113333131333333333333333111113
111111111122121221111111111111111111111111112121112111111111111111112112121111111211212211111111211121111111121112111111111111111221111111111111111111
111121111111111112211111111111111111111111111211111111111111111211111111111111111211222111111111111111111111112112111111112111112121121211221211112211
111211211111111111122111111111111112111111111112212111111111111111211111112111111111211111111112111111111221111121211111111111112111121111111211111111
112112121111111111111111111111111111211111121211111112112111111111111111111111111111111112111111111111121122112111111111111111111121111111111111221112
111111111111111212121112111111121111111111111111211111211111111111111121111111111111121111111111111112211121111121111112112112121211112111211111121111
111111211111121121111111111111111111111111211212111111111121111111111112111111221111111112111111112111121111111111111111111111121111111111112111112111
111111111111111111111112111111211121211111111111111111111112111111111111111112121111211211111111111111111112111211111221111111111212111111111111112211
121111211112111122112111111211111111111111111111111222222121111211111112111211112111111111111122111111122111121121111111211111121112111111111111111111
111111111111211111111211211111111111111111111111111112211211111212111112111111211221111111111111211111111121111121111111111111111212111211111112111111
111212111221111112111112111121112111111111111111112111111112121211211121111121111121111111211111121111111121121212212211212111111111211111111111111111
111111111222111111211111111111211111111111112111121111112211112121111111111111111111211212111122111111111121111111111111111121111111111111211112212211
111211111111212111121111111111221111111112211111111111111111111111112121211111111112111222111111111111121112111121111111111121111111221222221111111111
112211111111211211111111111121111111111111112111111112111111112111111121121111111211112111111111111112112111111111111111111111111221111111111211111112
211111121112111111111111111111111111111111111112111111111121111111111221111121111111111111111111111111111112211111111111122111111111111111111111111111
111111111111112111111111111211121111111112111111212111111122111121111111111111111111121111111111211122111111111112111112111121111211111111111111112111
112111111211122211122111111111111111112111111111111111111111211111111111111221121121111211221111111111111111112111111111121211212112121111112112111121
112111111111111111111111111111111112211111111111111111111111121121111111111111121211111112111111111111121111111212111111111111111111111111111211111111
111121111112111111112211211211111111121112111121122112111211112121111111111111111111111111111121111111111111111111111111111211212211111121111111111111
111211111111111111111111111111211111111111111211111111111111111111122111111112211111121211111111111111111111111111111111112111111111111211111121111121
211111111121111111111111111211112121111211121111211111121111111111111111112212111112111121111111111111111121111212111111111111111111111111111111111111
111111111111111111111211111111111112112211111211111111111111111121111112111211111111121111111112111111112111111111111111111111112111112111112111211111
111111111212111111211111111112221111112112211111111111111111111212111111211111111212111111121111111121111112111112111111111121111111111211111111111111
111111111111111111211121121111121111221212111111112111111211121121111111112212211122111111112111111111111111111211121111111111111121111211112111111111
112112111111111111111221121111111111111111111112111111111111111111121111211112111111111111111111111121111111111111111111111111111111111111111121111111
112111111121111111111111111111111111121111111111211111211111111111111112111112221111121121111111211122121111111212111112111111111111111121121111221111
111211111111111121111111111111111211111111111111111211111211111111121111121111111121112111121112121111111112111211111111111111121111111211111111111121
111111111111111111121111111112111111111211111211112111111111111112112122121121221111111211111111211112111121111112111111111111111111111111111111111112
111111212111111111111111111111111211111111211111111111121111211121111111112111111111111111111111121111111111121211211221111111111111121111121111211121
111111111111121111111121111111121112111111211121111211111121111111111212111111121111111111111111211111111111111121121111211211111211121121121111121111
111111111111121111211111122211121112111111112111111111111211111211111111111111111211111111211111211111111111111111111211111111112111211111111111211121
111111111211221121111111111111111112111111111121111111121111121111111111111111111111121111111211212112211111111111111121112111111211221111111112111112
111111211212111111211111211111111111111111111111112221112111111111111111111111211111121111121111111111111111112112111112111111111111111112111111111121
111111111111111111211111111111211111121111121111111111121111111211121111111111111111111111221111112111111111211112111111111211121111111111211111111111
111111111111111111111121111111121121111111211112121111111111121111111211111112212111111111111211111111111112112112111111111111111111111111111111112111
111111211111111111111111122122111111111112111111111211111112111111121111111121111111111211111111111111111111111111121111121111111111121111111111111111
211112111111111111122111111111111111211111121112111111112111111121111111111121121121111112111111111212111111121111111111112111121111111121111111111211
111111111111111121111111112111111112122112111111122111111111221111111111121111112212111121111121111112111211111121121111111111111111111111111111112111
111121111112112111111111111211111121121111111111111111111111112111111111111112211121121211211121111112111111211121111112111111112111111111121111111211
111111112111211112111212111121111111111211111111111111211111121112111111121111211111121111111121112111111111111121111111121111111111121111112121111111
111121111211212111112111111111211111111112111111112111111111121211211111111111211111111111211112111111112111111211111112112111111111111111111211111111
111111111111111111121111111211111111111111111121111121211111111121111111112111111111122122111111111112111121111111111111111111111112111111121111111122
221111111112111111111111211111111111111122111111221111211111111121111211112111111111111112211112212112111111111111111121111121211111111111111111111112
111211111111111211111211111111211121111111211112121121111111121111112122111111112111111111111111111111112111111111112121112111111211112112111221211111
111112111221111111111111112121111111111111111111111121121112111111112211121211211111111111122112111111111211111111112111111111111111111111111111112111
211111111111121121122111112111111121122111112121111111121111111111111111111121121211111112122221211211111111111111111112112111111112211122121121111112
111111121111112121111111111121111112111111112111211121112111111111111211111111111111111111211112211221211111111112111121111211111212111111111111111121
111112111121111211111111111121112211111111111111121111111111111111111121121111112121111211212111111211111111111111111111111121111111111111111111111111
111112112111111112222111121122211111111111111111111111111111112111111121111111111121111111111111111111111111121211211111111111112111111111111111112111
121111111111211111111112111111111112112121122121111111111111121221221111112111221112111111111111211111122111111111112111211111111111111221121111111111
111111111111111121121111111211111111211112112211111111111111112222211121111111111211111212111112111111111112121111111112111111111221112111111111121111
111111111211111111121111111121111111111111111111111111111211111111112111111111111111111111111111111121212112221111111111111111111111111111111112211111
112211121212111111111111111111112111111111211111211111211111211111121111111111111111111111211211112111111111111111111111112111211121111111112111111111
121111111111121111211111112211211111111121111111111111111211111111111111111111112111111221111111111111111111111111111211111111111112121111111121111211
111111111111111111111211121111111121221111111111112111111112111111111112121111121211121121112111111121111111111111111111111212121111111112111111111211
211112111111111112111111111111111111112111121112111111211111111111111111111111111111111111111111121121111111111111111112111121111111111111111111111111
111112111112112111111111112111111111111221111111111111111111211111111111111111111211111211111121121112111111111112111112111111111111111112111111111111
111111111112111121111121111111121211121111121111111121111111111111111111121111121211111112211111121112211112211111111211111121112111211111111111111111
121111111111111111111111211111111111111111111111111211211221211111111111112111111111111112211111111211111211112122111111111111111111111112111121111111
121111111111111111111111111111111221111112111111112221111111111111111111121111111212211111111111221121111211121111212111111111111111121112112111111211
111111111111112121111121211111111111111111111112111111112111111122111111112211111111111111111121112111111111111112111111111111211111112111111111111211
111111111111121111211111111121111111111111111111211111112111112111111111111112211112212111111111111111111111111111111111212111121111111111111111111111
121111112112111121112211112111111111112111112221111111112111111111111111111111111211111111111111112111111211121222111112111111111111112111111111111111
111111111111121111111111111111111211221111221121111112121112211111112112111112111111111212111121112111111111211112111111122111111211111111111111121121
111121111111111111211211112112111111111111111111111111221112111112121111211211111211111111111111111111111111111211111122111111211112111111111121111111
111111111111111111111111121111111111111111111111111111111111111111111111112211122211121111111111111111111111112111121111111212212111211111111111111111
111111111111111111111111112111122211122211121111111111111121111111111112122112111112111111111111111111121112111211111112111121111111111111111111111111
121111111111111111111111111112111111111121111111111111122111111211111111121211111121111111111111111211111121111211111111111111111111211121111121212121
111111121112121111111111212211111111211112121211111111211121111111111121121111111112111211121111111111111211112122111111111112111211111111221121112111
111111111111111111111111111111111111111111111111111112111111111111111112111111111121111111211111111111111111111111112121112111111111111111111111111111
211111111111111121111121211111111121122111111112122121111111111111112211111111111112112111111111121111111111111111111111211111112112111111111111111211
121211111111111111111111111121112111111111111111111211121111111111121111111112211111111111111111112111111121111111111221122211121111111111111111212111
121111111111211111111112111121111112111111111121111212111111121111111111111112111111111111111111111211211111111112111211111111111111111211111211221111
211111121211111211111111111111111112111111211211121111111211111111111111111111111111111111211111111111121111111111212121211121111111111122112111111111
111111112121111211111111111111111111111111111211112112221112111111111111111122111111111111121121112111111111111111111212112211111111112111111112211112
221121111111121221111221111111111211111111111111111111111111111111221111111122111121211111111111112111111111111111111111112111111211112111111111111111
111111111112111111111111121212111111111121111111111111121111112111211111111122212111111111111111121111111111211121111111111111111111111111111111111111
111111111111211111111111111121111111111111112211211111111211111111111111111211111111111111111121111111111111111121111111111111112111111111111111111212
112112111211211111111111122111121111211211211111111112111111111111112111121111121111111211111121111111111111211111111211211111211112112111111111111111
112211111111121121112111111111111121111112211111111211221111121121111211222121121211111111111111111111111111111111111111121111111211112111111121111121
111111111111111211111111111111111111111111111111121211111111111111111221121111111111111111111111111111111121212111111112111111111111111111111121111211
112112111112111111111211112111211211121211111111111111111111112111121211111111111111111111112111111112111212112111111111111211211111211111112211111111
121121122111111111111111112111111221121111112111111111111111111111111111112112111111111111111111111112121111111111111211111112111211211111111211211212
121111122111211111111121111111121111221112111111111211111111211111111111211211111111111111121111111121111111111111111111112111111111211111111121111211
111212111111111111211111111212111121111111111112111111111111111121111111111122211111112111111211211111111111211111121111111111111111111111111111111112
211112121112121111111111111211111211111111112111111211111111111211121111112111121111121111111111111111111111121121121111112111211111111111211211211111
211111121112111111111211112111111211111111121111111111121111111111111111111111111212112111111221212111111111121111111121111111121111211121121212211111
121121111111111111111121111111212111121111111111111111211111111111121111111111112111111111111111111111111111211111222111111111111111111111121121121112
111111111111111211111221211121111111122112111111111112111111111211211111111111111111111111211111111121212111111111111121111121111211111111111111111121
211111112111121111211111112111221111111111112111112211111111122211112111211111121111111111111111121111111111112111112111112111111111111121111111112111