000000000000000000000000000000000000000000000000000000000000000000000000000000000000000000000000000000000000000000000000000000000000000000000000000000
000000000000000000000000000000000000000000000000000000000000000000000000000000000000000000000000000000000000000000000000000000000000000000000000000000
000000000000000000000000000000000000000000000000000000000000000000000000000000000000000000000000000000000000000000000000000000000000000000000000000000
000000000000000000000000000000000000000000000000000000000000000000000000000000000000000000000000000000000000000000000000000000000000000000000000000000
000000000000000000000000000000000000000000000000000000000000000000000000000000000000000000000000000000000000000000000000000000000000000000000000000000
000000000000000000000000000000000000000000000000000000000000000000000000000000000000000000000000000000000000000000000000000000000000000000000000000000
000000000000000000000000000000000000000000000000000000000000000000000000000000000000000000000000000000000000000000000000000000000000000000000000000000
000000000000000000000000000000000000000000000000000000000000000000000000000000000000000000000000000000000000000000000000000000000000000000000000000000
000000000000000000000000000000000000000000000000000000000000000000000000000000000000000000000000000000000000000000000000000000000000000000000000000000
000000000000000000000000000000000000000000000000000000000000000000000000000000000000000000000000000000000000000000000000000000000000000000000000000000
000000000000000000000000000000000000000000000000000000000000000000000000000000000000000000000000000000000000000000000000000000000000000000000000000000
000000000000000000000000000000000000000000000000000000000000000000000000000000000000000000000000000000000000000000000000000000000000000000000000000000
000000000000000000000000000000000000000000000000000000000000000000000000000000000000000000000000000000000000000000000000000000000000000000000000000000
000000000000000000000000000000000000000000000000000000000000000000000000000000000000000000000000000000000000000000000000000000000000000000000000000000
000000000000000000000000000000000000000000000000000000000000000000000000000000000000000000000000000000000000000000000000000000000000000000000000000000
000000000000000000000000000000000000000000000000000000000000000000000000000000000000000000000000000000000000000000000000000000000000000000000000000000
000000000000000000000000000000000000000000000000000000000000000000000000000000000000000000000000000000000000000000000000000000000000000000000000000000
000000000000000000000000000000000000000000000000000000000000000000000000000000000000000000000000000000000000000000000000000000000000000000000000000000
000000000000000000000000000000000000000000000000000000000000000000000000000000000000000000000000000000000000000000000000000000000000000000000000000000
000000000000000000000000000000000000000000000000000000000000000000000000000000000000000000000000000000000000000000000000000000000000000000000000000000
000000000000000000000000000000000000000000000000000000000000000000000000000000000000000000000000000000000000000000000000000000000000000000000000000000
000000000000000000000000000000000000000000000000000000000000000000000000000000000000000000000000000000000000000000000000000000000000000000000000000000
000000000000000000000000000000000000000000000000000000000000000000000000000000000000000000000000000000000000000000000000000000000000000000000000000000
000000000000000000000000000000000000000000000000000000000000000000000000000000000000000000000000000000000000000000000000000000000000000000000000000000
000000000000000000000000000000000000000000000000000000000000000000000000000000000000000000000000000000000000000000000000000000000000000000000000000000
000000000000000000000000000000000000000000000000000000000000000000000000000000000000000000000000000000000000000000000000000000000000000000000000000000
000000000000000000000000000000000000000000000000000000000000000000000000000000000000000000000000000000000000000000000000000000000000000000000000000000
000000000000000000000000000000000000000000000000000000000000000000000000000000000000000000000000000000000000000000000000000000000000000000000000000000
000000000000000000000000000000000000000000000000000000000000000000000000000000000000000000000000000000000000000000000000000000000000000000000000000000
000000000000000000000000000000000000000000000000000000000000000000000000000000000000000000000000000000000000000000000000000000000000000000000000000000
000000000000000000000000000000000000000000000000000000000000000000000000000900000000000000000000000000000000000000000000000000000000000000000000000000
000000000000000000000000000000000000000000000000000000000000000000000000000000000000000000000000000000000000000000000000000000000000000000000000000000
000000000000000000000000000000000000000000000000000000000000000000000000000000000000000000000000000000000000000000000000000000000000000000000000000000
000000000000000000000000000000000000000000000000000000000000000000000000000000000000000000000000000000000000000000000000000000000000000000000000000000
000000000000000000000000000000000000000000000000000000000000000000000000000000000000000000000000000000000000000000000000000000000000000000000000000000
000000000000000000000000000000000000000000000000000000000000000000000000000000000000000000000000000000000000000000000000000000000000000000000000000000
000000000000000000000000000000000000000000000000000000000000000000000000000000000000000000000000000000000000000000000000000000000000000000000000000000
000000000000000000000000000000000000000000000000000000000000000000000000000000000000000000000000000000000000000000000000000000000000000000000000000000
000000000000000000000000000000000000000000000000000000000000000000000000000000000000000000000000000000000000000000000000000000000000000000000000000000
000000000000000000000000000000000000000000000000000000000000000000000000000000000000000000000000000000000000000000000000000000000000000000000000000000
000000000000000000000000000000000000000000000000000000000000000000000000000000000000000000000000000000000000000000000000000000000000000000000000000000
000000000000000000000000000000000000000000000000000000000000000000000000000000000000000000000000000000000000000000000000000000000000000000000000000000
000000000000000000000000000000000000000000000000000000000000000000000000000000000000000000000000000000000000000000000000000000000000000000000000000000
000000000000000000000000000000000000000000000000000000000000000000000000000000000000000000000000000000000000000000000000000000000000000000000000000000
000000000000000000000000000000000000000000000000000000000000000000000000000000000000000000000000000000000000000000000000000000000000000000000000000000
300000000000000000000000000000000000000000000000000000000000000000000000000000000000000000000000000000000000000000000000000000000000000000000000000000
100000000000000000000000000000000000000000000000000000000000000000000000000000000000000000000000000000000000000000000000000000000000000000000000000000
133000000000000000000000000000000000000000000000000000000000000000000000000000000000000000000000000000000000000000000000000000000000000000000000000000
111000000000000000000000000000000000000000000000000000000000000000000000000000000000000000000000000000000000000000000000000000000000000000000000000000
111000000000000000000000000000000000000000000000000000000000000000000000000000000000000000000000000000000000000000000000000000000000000000000000000000
111303000000000000000000000000000000000000000000000000000000000000000000000000000000000000000000000000000000000000000000000000000000000000000000000000
111101330000000000000000000000000003003000000000000000000000000000000000000000000000000000000000000000000000000000000000000000000000000300000030000000
111131110000000000000000000000000031001330000000000000000000000000000000000000000000000000000000000000000000000000000000000000000000333100000013000000
111111113000000000000000000000003011331110000000000000000000000000000000000000000000000000000000000000000000000000000000000000000030111100000311000030
111111111000000000000000000303031311111113000000000000000000000000000000000000000000000000000000000000000000000000000000000000000013111130300111330013
111111111300000000000000000131311111111111000000000000000000000000000000000000000000000000000000000000000000000000000000000000000311111113103111113311
111111111130000000000000003111111111111111300000000000000000000000000000000000033000000000000000000000000000000000000000000000000111111111101111111111
111111111110000000000000001111111111111111133000000000000000000000000003030000011000000000000000000000000000000000000000000000033111111111131111111111
111111111110300003000003031111111111111111111300000000000000300030003031013003311300003300003000000003030000003300030003000000311111111111111111111111
111111111113100031000001311111111111111111111130000000000003103010331011311001111103001100001000300001310000031100010001000000111111111111111111111111
111111111111133311333331111111111111111111111113333333333331131313111311111331111131331133331333133331113333311133313331333333111111111111111111111111
112111211112111111111111112111111111111111111111111111121121111211121121211111122111111121112111111111211111111112221111111111111111211121212111112111
111211111121211111111121211112111111111111111221111121111111111111111111211111211212112111111112111111111111111111111111111211111111121111121111111121
111211121111111111111211111111111111111111111211121111111111111112111111211111211112111211111111111111111211111111112121111111121111111111111121111111
111121111111111111211111111111121122111111111111111111111111121111111111121112111111112121211111111111111112111121111211211111121111111111111111121121
211111111111111211111111111111111111111111111111111111111111111211111111112111111111111111111111111111111111111111111111111111111111211211111121111111
111111111111111111111111111111111111111111211111111111111111112111111111111111211111121111111111111111111121221111211111112121111111111111221111112211
111121111112111111211111112112121111111111211111121111211112121111111111121121111111112111111112111211111212111111211111212111111111111111111111111121
111111121111212111211211111111121111111111111111211111111121121111111111111112111112111212111211111121111111111111112111121111111111111112111112212211
111112111111111111112212111211111111111111111111121211111211111111111111212111111111111111111112111111111111211111121111112112111211111111111222112121
111111111111111212111111111111211111111111111111111111111111111211111121111112121121111112111111221111111111111112111111111111112121111111112111111111
212111111112121111111122111121112112121111211111111111111111111111111111111111111221111111111111111112111121111111211111111111111111111111111111121111
111221121111111111112112111111111211111111211111111111111121111111111121111111111112112111112111211211111111111111211111111111111111111121111111111111
111121111111211111112111111221111111121111111111111121111111111121111111111111111112111111111112112111112111111111121121211111111121111111111112111111
221111111111111111111111111111211112111111111211111122112111211112111111111121111111111111111111121121111112111111112111111112111111111121121111111111
111111111111111111211111111111211111121112111111112111111112211211222212111221122111112111112111111111111111111211111111111111211111111111112121111211
111111111111112121211111121111111111111221112111111111111112212111122112121111111111111111111111111111111111221111211111211111122111111111111111112121
111111121112111211121111111111111111121121121111121111111111111211212111111111111111111111212211111211111111212111111111121111111122111122211221111111
111111111111111111111111111111121111111111111111111111211111111111111211111111111111111112111111111111111111112112111111111111111111111111111112211211
111111111111112111111111111111111111111211112111211111111111211111211121111111111111111221121111111111111111211211111111111212112111111111211212111111
111111111111122122112111111111111111111111111111111111111121121112111121111111111111111112112111111211111211111111211111111111111111111211111111111112
111211121111111111112211111111122111212121121111111221121111111211111111111211111111111111111111122111121121111111111211111111111112111111211111211212
111111111112112112111111111111111111111121222111211212111211111112111111111111111111111212111111111111111111112112111111111111111211111111111111121121
211112111221111111111111112112112111111111111111111121111111111111111112121111111212111121111122111122122111111111111111111111111111111111111211111111
111211111111111111111112111111111111211111111112221111111111211111112112111111211111211111111111111111111111111111111111211112111111111211111111211121
111112121211211121111111211111121122111111111111111111111211111111111111111111111112121111111111111111111111111121112111111212111111111111111111212112
211111112111111111111112112111111112121111121111111111211121111111211111111211111112112111111221112111211111111111121111111111211111111112211111112121
121121111121221111111111212111111111121122111211211211111122211211111111111121111111111111111111212111111111111111111111111221111111111111111111111111
121111111111212112111111112111111111121111111111111111221111111111121111111111121111111121111111111222111221121122211111111111111111111111121111121121
112111111211111111121111112111111222111121111121112121111111111111111211111111111121211111111111111111111111112111111111122111111111121121111221111111
112121112111111211111111111121112211112112111121111111111112111112111112112211111112111111111111121211211111211112111111111111111111111121111111211112
111111111111111121111111121111111111111122211111111121111211112111111111121111111111111111111111222121211111121111112121111112111121111111111111111111
111112111111111112121122111111111211111111111111111111111211211211211122112111111121112111122112111111121121111111112221111111111121111111111121111111
111121111111111111112111111112111111111211111111211111211111112112111112111111112112111111111111111111111212111111111111111112121111211122111111111212
211111111111212111211111111111111111111111111121111211111111111111111111121222121121111111121111111111111111111111111111111111111111111111111211112211
111111111111111111111111111221121111111111111111111111111111111211111111111111111111211111111112111111111111111111111121111121211111111111211211111121
111111221111111111111121122111112211121211121111111111121111111111111121111111111111111121111111111111111112111111111111111111121111111111121111111112
111111111211111112121221111111111111121111121211121111111111111111111211111111111121112112122111111111111111111111111112111111112121211121212112112111
111111111121121111111112111212111121111211121111121111111111111121111111111111111111112111211111221111112211211112111111111111111111111211121111111111
211111111111121111211121111111111111211111111111111111111111112111111211112111111121111211111121111121211111111111111111111111111111211122111111111121
111111211111111121112111111111211111121111111111111111111221112111111111111111111211111111111211111111111111121111111111111112111111111111111111111111
112112111112111211121111111211211111111111111111111121121112111211111111111111111111111111111111121111111111112211111211111111111111211111111211111111
111111111111111111111111111211111211111111111111112122112111111111211111111111111211111111111111111111111122112112121111122121111211211111111111111111
111111211112111111111211111111111111111111122111111111111111111112111111111111111212111111111111111112121121121111112121111111111112111111121111111122
111111111111121111212111111111111111111111111111111121111111111121111111111111212111112121111111111111111111211111111111121121211211111112121111111112
222111122111121211111111212111211111221112111211112111121121211111111111111111111111121111111111121111111211111111111211111121111111111111112111112111
211111111111111111121111121111111122111111111111111122211111111111111111112211111111112111211111111211111111111111111121111111111111121111111112111121
111111112111111111111111211111111221212121111111111112211111112111111111112121111111111111111111111221111111221111111211111111121111112111122111212111
111111211111111111112111111111121211111111211111111111111111111111112111111111111211111111111111121111112111112111121112111111111112111111111211111111
121111211111211111111111111121122111221112111212111111111212111111121121111111111111211111111111221112111111111111111211111111111111121111111111111111
111111212211111221111112111111211111111111111111111121111111111211111211111111111111111111211112121111112121121111111111211111111221121112111111111111
111111111111111121111111111111111111211111111111111111121111111111211111111111111211112111111121112111112111112111111111221111111121111112111111212111
111111111111111121221111121111111111111111111211111111112111111111111111111111111112111121111111111111111111111211111112111111211122111211112211121111
111111111111111111112111211211111111111211111111111121111111112111111121111212112111121111111111111111111111111111111111111111111111211111121112111111
111111111111211111111121112111111111111111111221111211111111112122111111111111111111111111111111112111111211111121111111121111112111111211111111111111
111111112111211211112111111111111111111111111111111111111111111111111111111122211111111122111111122111111111111111111111121111111211111111111111111111
111111111211111111111211111111111121212111111111111211112111112111211111111111211211221111211211111111111211111111111111111111111111111211111111111111
111111121111121111211111121111211111221211111111111211211121111111111111111111111112111111111121211111111111121111111211111111111112111111111111121111
112111112111111111111111111112111111112111111211211111112111111111111211111111111111111111111111111111111112121111111111111111111121111111111111111111
111121111111111112111111111111111111111111111121112111111211111111111221111111211112122111221111121111121121111211111111111121111121111211111111111111
111111121111111121111111111111211111111111211111122111121111111111111112111111121112111111112111111111111111111111111111111111121112112121112121111111
111111111111111111122111211211111111111111121111112111111111111211122121111112211111121111112111112111111112212111111211111121111111111121111111121121
112111111211111111111111111111111111211121111111121111111112111211111111121111111111211111111111111111111111111121121111121111111111111111111111122111
111111111111111111111111111111111111111211111111211211111111111111111111111111121111211111111111121111111111111112111111221111111111112112111111111111
112121111111111111111111111111111111111111221211111121111111111111121211112211111111111111112111111111121112211111111111111111211112121211211111111221
121112112121111111111211111111111111121111111111111111111211211111111121111111111121111111112121111111112112121111111111121111111111111111121111111121
121111211121112121111211112111111211211111112111111111111121111112111111111111121111111111111111111111121111211111111111111111121111111111111111111111
211111111121111112111111121121111111111212111121111222111211111211111111111122111111211121111111121111111211211121111111111122111111111212111111121111
112112111121111211111111111111111111111111212111111211211112111112111112111111122211111111111111211111211211111112122121111111111211111112111122111112
111111112121111121112112111111111111112111111111111111111111211111112111111111111112111111111111111211111111111111112111111112212211112111111121111111
111122111111111111111112111111111111111221111111111111112111111111111221111111111111111112111111111221111111111121111111111221111111111111111212111111
111111121212211111112111111111111111112111112111111111111111211122111111112112111111111111111111122121111121111111111112111111111111111111121121111112
111111112111111111111121111111111111112111111121111211111121111111221111111111111121111111111111111112111111111211111111111111111111111211211111121112
121111111111111111111111121111111111111211111111122112111112111111211111211111111111111112111111112121111111111111121221211111111111111111111111211111
111111211111112111212111111111111111111121111111111211111111111111111111111111121111211111111121121211111111121121111111111111111111112111111111122111
111111111111111111111111111111121111111211111112122111111111111111111111111111121111111111112112211111111111111111121111111111111111121111111111111111
111111111111121111111111211211111212112112111111111112121111211111121112122111111112121111111211121111111111111111112111111111111121112111112111221111
111121111111211211111111121111111111111111111111111111111111112111221211111111111111112121111111121111211121111111111111211111111111112111221111111111
111111112121111111111111111111111111111112111111111112111121111111121111111111111111211111111111111111111211111111111111111111122112111111111111111111
111111111111111111111111121111211121111111111111121111121211111111111111111111211111121121111111111111121211111111111111111111111111121112112111111121
112121111111111111111111111111122112111121111111121111112111112111211111112111111112111211211111111111211111112111121111111111111111211111211111111111
111111111111111111111112121112111222111121111111111111111112111111111111111111121111111111111212111112111111111111111111111111111111111211111122111111
112111111111111111121211112111111111111111111112111111112111111122111211111111111121211111111111221111111111111111212111111221112111111111111121211111
211111112111111111111121111111111121111111111121111111111121111111121111211111121111111211122121111121111112112111112211211111111111111111111111122111
121111111111111111111211111111121112211111111111121111111111111111111121122112112111111111111121111121211111111221111111211122111111111112112112111111
211111111112112121111112111111221111111112211121211111111111111111121111111111111111211111111111211112111111111121111111111111211112111111121112211111
211121111121121111111211111122111121221111111121111111112111111111121111111111111111121112111111111211111111111212111211111112111111111111122111111111
212121211111111111111111121111111211111211211111112211111111111211121111111111122111111111111111111112111111111111111211111112111111112121112121111121
111111111111111111111111111111111211211112111111111111111211111111111111121111111111111111111111111212211111122111111112111111121111111112111111121111
211121212111111111111111111111112111111111111111111111112211211111211111111111111111111111121111211111111111112211111112121122111111111111111121111121