000000000000000000000000000000000000000000000000000000000000000000000000000000000000000000000000000000000000000000000000000000000000000000000000000000
000000000000000000000000000000000000000000000000000000000000000000000000000000000000000000000000000000000000000000000000000000000000000000000000000000
000000000000000000000000000000000000000000000000000000000000000000000000000000000000000000000000000000000000000000000000000000000000000000000000000000
000000000000000000000000000000000000000000000000000000000000000000000000000000000000000000000000000000000000000000000000000000000000000000000000000000
000000000000000000000000000000000000000000000000000000000000000000000000000000000000000000000000000000000000000000000000000000000000000000000000000000
000000000000000000000000000000000000000000000000000000000000000000000000000000000000000000000000000000000000000000000000000000000000000000000000000000
000000000000000000000000000000000000000000000000000000000000000000000000000000000000000000000000000000000000000000000000000000000000000000000000000000
000000000000000000000000000000000000000000000000000000000000000000000000000000000000000000000000000000000000000000000000000000000000000000000000000000
000000000000000000000000000000000000000000000000000000000000000000000000000000000000000000000000000000000000000000000000000000000000000000000000000000
000000000000000000000000000000000000000000000000000000000000000000000000000000000000000000000000000000000000000000000000000000000000000000000000000000
000000000000000000000000000000000000000000000000000000000000000000000000000000000000000000000000000000000000000000000000000000000000000000000000000000
000000000000000000000000000000000000000000000000000000000000000000000000000000000000000000000000000000000000000000000000000000000000000000000000000000
000000000000000000000000000000000000000000000000000000000000000000000000000000000000000000000000000000000000000000000000000000000000000000000000000000
000000000000000000000000000000000000000000000000000000000000000000000000000000000000000000000000000000000000000000000000000000000000000000000000000000
000000000000000000000000000000000000000000000000000000000000000000000000000000000000000000000000000000000000000000000000000000000000000000000000000000
000000000000000000000000000000000000000000000000000000000000000000000000000000000000000000000000000000000000000000000000000000000000000000000000000000
000000000000000000000000000000000000000000000000000000000000000000000000000000000000000000000000000000000000000000000000000000000000000000000000000000
000000000000000000000000000000000000000000000000000000000000000000000000000000000000000000000000000000000000000000000000000000000000000000000000000000
000000000000000000000000000000000000000000000000000000000000000000000000000000000000000000000000000000000000000000000000000000000000000000000000000000
000000000000000000000000000000000000000000000000000000000000000000000000000000000000000000000000000000000000000000000000000000000000000000000000000000
000000000000000000000000000000000000000000000000000000000000000000000000000000000000000000000000000000000000000000000000000000000000000000000000000000
000000000000000000000000000000000000000000000000000000000000000000000000000000000000000000000000000000000000000000000000000000000000000000000000000000
000000000000000000000000000000000000000000000000000000000000000000000000000000000000000000000000000000000000000000000000000000000000000000000000000000
000000000000000000000000000000000000000000000000000000000000000000000000000000000000000000000000000000000000000000000000000000000000000000000000000000
000000000000000000000000000000000000000000000000000000000000000000000000000000000000000000000000000000000000000000000000000000000000000000000000000000
000000000000000000000000000000000000000000000000000000000000000000000000000000000000000000000000000000000000000000000000000000000000000000000000000000
000000000000000000000000000000000000000000000000000000000000000000000000000000000000000000000000000000000000000000000000000000000000000000000000000000
000000000000000000000000000000000000000000000000000000000000000000000000000000000000000000000000000000000000000000000000000000000000000000000000000000
000000000000000000000000000000000000000000000000000000000000000000000000000000000000000000000000000000000000000000000000000000000000000000000000000000
000000000000000000000000000000000000000000000000000000000000000000000000000000000000000000000000000000000000000000000000000000000000000000000000000000
000000000000000000000000000000000000000000000000000000000000000000000000000900000000000000000000000000000000000000000000000000000000000000000000000000
000000000000000000000000000000000000000000000000000000000000000000000000000000000000000000000000000000000000000000000000000000000000000000000000000000
000000000000000000000000000000000000000000000000000000000000000000000000000000000000000000000000000000000000000000000000000000000000000000000000000000
000000000000000000000000000000000000000000000000000000000000000000000000000000000000000000000000000000000000000000000000000000000000000000000000000000
000000000000000000000000000000000000000000000000000000000000000000000000000000000000000000000000000000000000000000000000000000000000000000000000000000
000000000000000000000000000000000000000000000000000000000000000000000000000000000000000000000000000000000000000000000000000000000000000000000000000000
000000000000000000000000000000000000000000000000000000000000000000000000000000000000000000000000000000000000000000000000000000000000000000000000000000
000000000000000000000000000000000000000000000000000000000000000000000000000000000000000000000000000000000000000000000000000000000000000000000000000000
000000000000000000000000000000000000000000000000000000000000000000000000000000000000000000000000000000000000000000000000000000000000000000000000000000
000000000000000000000000000000000000000000000000000000000000000000000000000000000000000000000000000000000000000000000000000000000000000000000000000000
000000000000000000000000000000000000000000000000000000000000000000000000000000000000000000000000000000000000000000000000000000000000000000000000000000
000000000000000000000003000000000000000000000000000000000000000000000000000000000000000000000000000000000000000000000000000000000000000000000000000000
000000000000000000000001000000000000000000000000000000000000000000000000000000000000000000000000000000000000000000000000000000000000000000000000000000
000030000000000000000331300000000000003000000000000000000000000000000000000000000000000000000000000000000000000000000000000000000000000000000000000000
000310000000000000000111130000000000031000000003030000000000000000000000000000000000000000000000000000000000000000000000000000000000000000000000000000
330110300000300000003111110300000000311000333031313300000000000000000000000000000000000000000000000000000000000000000000000000000000000000000000000000
113113133000100000001111110100000000111300111311111100000000000000000000000000000000000000000000000000000000000000000000000000000000000000000000000000
111111111033103000031111113100000003111103111111111100000000000000000000000000000000000000000000000000000000000000000000000000000000000000000000000000
111111111011131030311111111133000301111101111111111133000000000000000000000000000000000000000000000000000000000000000000000000000000000000000000000000
111111111311111010111111111111030131111131111111111111303000000000000000000000000000000000000000000000000000000000000000000000000000000000000000000000
111111111111111313111111111111013111111111111111111111101003030000000000000000000000000000000000000000000000000000000000000000000000000000000000000000
111111111111111111111111111111311111111111111111111111131001010000000000000000000000000000000000000000000000000000000000000000000000000000000000000000
111111111111111111111111111111111111111111111111111111111331313000000000000003000000000000000000000000000000000000000000000000000000000000000000000000
111111111111111111111111111111111111111111111111111111111111111000000003000001030000000000000000000000000000000000000000000000000330000000000000000000
111111111111111111111111111111111111111111111111111111111111111030000331000331010000000000000000000000000000000000000000000000000110030000000000000000
111111111111111111111111111111111111111111111111111111111111111310000111003111310000000000000000000000000000000000000000000000003113010000000000000003
111111111111111111111111111111111111111111111111111111111111111110033111301111113033000000000000000000000000000000000000000000001111310300000000030301
111111111111111111111111111111111111111111111111111111111111111113011111131111111311000000000000000033000000000000000000000000331111113130000000010131
111111111111111111111111111111111111111111111111111111111111111111311111111111111111000000000000030011000000000000000300000033111111111110000000313111
111111111111111111111111111111111111111111111111111111111111111111111111111111111111300000000030013311003000000000000100000011111111111113000030111111
111111111111111111111111111111111111111111111111111111111111111111111111111111111111133333333313311111331333333333333133333311111111111111333313111111
111111111121111211111111211112111111111212111111111111111111112111111111122111112122211211111111211111121111111111111111121111111112112111121111111111
122122111111112111112111111112111111111111111211112111111111111111111111112111111111111121111111211111111111111111122111212112111112111111111111112111
111112111111111111111111122111111111111121121211111112121111121211111121112111121111111112111211112111121112111121111112211111121111111111111111111111
111112112211211111111122111121221111211111111121121111111111111111111111121111111111111111211111111111111111112212111111111211111111112111112111121111
111211111121111221111111112211111111211111122121121111111111111112111111121121111112121211111111111121111111211111111221211121111112111222111121122111
112111111111111111121111211111111111211111111112111111121111111111112111121111121111111111111111211121111111121111111211111111111111222111111111111112
111211111122111121111111112111111121211111111111111111111112121111111111121112111111111111111111111121111221121211111111111211111111112111111211121111
111111121111111111111111112112121212111121211121111111121112112122211111111211111111121112111111111211111121122111211111111111111111211112111111111111
111112111111212111111121111111111111111111111111111221211111111111111211211111111121111111121111211121111211111111121122111111111111111111111111111111
111121111111211112111112122111111111121111111121111111111111211111111112111111111111211111121112111111111121111112211211111212111121111111111212111111
211121111112111112211111111111112111111111111111112212111111111111111111111112111111111111111111111111111111111111111111111111111211111111111111112111
121111111111111112121111111111111111211112121111111111211211111112111111111111112211111111211111111121111121211111111211111111111121212211111112111111
211111111112111211121111111111111211111211111111111111111211111111121111121111111111111212111111111121111111111111121111121111111111111111212111111111
111111211111111112111111111111111221111111121111111111111112111111112111111111111111111211111111111111111121111111111121112111211111121121111111111112
112111111111111112111221111211111111121211111111121111111111111111111111111111111111111211211111111121111121112112111111211112121111111111121111111111
111111111111111111111111111121112111211121111111111211111111111111111111111111211111111111111111111111111111111112111112111111211111111111111122111111
211211211121111111111111111112111111111121112112211112111111211111212111111111111111111211112111111121111111111111111111111111111111111111111111211111
111121111111111111112111111111111111211111111111121121121111121111111111112111111111111221111111211111111111111211111111112111111111111111111111111211
111121111221121111111111121121111111111111111111112112211111111121111111111111112221111111112121111111111111212111111111111111111111222111211112212111
111111111111112111111111111121111111111111111121111111211111111111211121121111212211111111111111111112111111121111111112111111212211121111111112211111
111111111111111121121111111112212111211211111111111211111111121111121111111121111111111111111111111111111112211211111121111111221221111111111211211111
111211211121111111111111111121111121111121211111111111111211112111111112211111112111111111121111211111111111111111111111121111212111111111111111111112
111111121111111111111121111111111211111211111111211212112111111111111211111111111211111111111111211121121111112111121122111111111111112121111111111111
111111111211111211111111111121121112111121111112211121111121111111121121111111121112121111111111111111212111121111121111112111111111111121121111211112
111111111121112112211121111121111111111111111211111122211111221111111112111111111111111111121111121111111112112111121111111111111211121111121211111111
111121211122111121211111112111111111111121111111111111111111121111111112111121111111212111211121111111111111212112111111111121221121112211111111111111
111111111111111112111111211111111111121111111211111111211111121121111211211111111121111111121111111111112111111111111211111121211111111111211121121111
211111121112111111211111221111111111111111111111111122221111112111111111111111111111111111111111111111111111111111111112111111111111111121111221111111
111121111221111111111211111111111111212111211111121112111111121111111111112211121111111111111211121121112122122111121111221111111211111212111211112111
111111111211112111112111112111211111111111111111112112111111111112111111121111111111211212111122211111111111121111211111111111211111111211121111111111
111111111112111121211112111121211111111211111122111212111111112111111111121111111111111221111111111112111221111111111111211111211111121111111111111111
211111111121112111111111111111111112111111121112111211211112212211121111111211111111112121111111121111111111111111111111112111121111211211112111111111
121111121111111111211121111111211111111111111111122111111111111111211111211111121122111112111111112112111112211111111111111111111111111112111111111121
111111111112111111121111111121111121211112111111121111111111211111111111111111121111111121111211112112111211111111211111112111121111111121112111111111
111211211111111111111121112222111112111121211111212211111111112111222111111211111121111111211112211211111211111111111111112221111111111111112111111111
111121111211111111111211111111111111111111121211211111111111111111121111111111112111111121111111211211111112111111111111111111112111111111111111111111
111121111121221111111111111111111211111121111111111111111121211122112111111111111111111111111111111211111111112112111111211111211111112111111122211211
121111111111211111111111112112111121212111111111122111111111111111121111121111121111112111111121121111111111111111112111121111211111111121121111112111
111121111111112111211111121112112211111111112111121112111121111111112111111111111111121121112111211111111111111111112122112111111112111111121111111211
112112111111111112111111112111221111111111121111211111222121112111112211111111111111111112111111121112111111111111112121111112111112111111111111111111
111111211111121111111111112111111111111212111112112111112212111111121111111111211111111111111211112121211111111211111112111111111111111111121111111121
111111111111111122111111111111121211111111111111111112111112211112211121111111111112121211121211212111111111111111211112211111111111121111111121111111
111111121111111211121111111111111111111111111211111111111111111111111111111111111111111211112111111211111111121111111111111111111111211111111111111112
111111111111111111111111111211111111111111112211111111111111111111111111111111111121111111111121111111111112111111111211111221121111122111121111111121
111111211111111112111112111211211111111111111111111212111111221121121111111111111111211111211111111121111111111111111111111111111111112111112121111112
111211111111211212111121111111111111112111211111111111111112111121111111111111111111111121211111211111111111111112111111221111112111111111112211112112
221111111112121111111211111111111111111111111111111211111221112111111121111111111111111121111111111121111112111111111211121111112111111111112211111111
111111111211111111111111211121111111111111111111111211112211211111111111112111112211221111111112111111111211111211111121111111111111111211111121111111
121111211121111111111111121111111111211111112111111111111111211111111111111112111111111211112111121111111111111111111112111111121111121111111111111211
111121111111111111111111212111111111111121111111211111111111121112111211111111121111111111111212121221111111111111111211111211111112111111111111111111
111211121111121121212111121211111111111111111111111112111111122111111121111111111111111121111121112111112111112211112111111111112111111111111122112111
111111111111111211111111111111121111121111111111111111221111111111121111111111111111111111121111221111112111111112221111111111111122111121212111112111
122211111111121112111111212111111211111111111112122111121121111121121111111121111111111111111111111111111111122111111111121111111211111111111111211121
211111111211212111111211121111111111112111111121111111111111212211111111112112111121111112111111111111112111111111111111111111111111111111121111111111
111111111111121111111121122121211121111111112111111121111121111111111111112111111111111111111212111111111111121111112121111111221111111111221112111212
221111111112111111111111111111211111211111112111111112111112111121211111111111111111111112222111111211111111112121122111112111111121111111111111122211
111111111111111121111111222111111111111111111111111111111111111111111111111111111111121111111111111111211111111221111111111111121111111211111111121111
111112111121111111111111111111111122121111111111112211111211111111121212111111111111111111111111112111211121111111121211111211111211221111111111111111
111111111111211211111112111121111121111111111111111111111121111111111112111112121212111111111211111112111121111111111111121111111121211211121112111111
112111111112111111211211121211121121122111111121111212111111121111121111112111111111111211211111111111111111112111111111111111111111111111221111112111
111111112111111111111211111111111112111111211111111111211111212111121111111111211111111111111121111111111111112111122111111111111111111121111111111111
121111111111111121112111111111111111111111111111121112111111111121112112111111211111111111112111111111111111111111111121111111111111111112111111111111
211211121211211211111121121111111111112111211111111121121111111111111111111111111111112211111111111121112111111111121112111111111111111111112111111211
111112111111111111111121111111111121122111111111212111221121112111111112121111212111121111111111111111111211111112121111112111111112111111111111111111
111111111111111111112121111111121111121111111111111112211121111212111112111211111112111111121221111111111111121111111112111121121111111111122112121111
111111111212111111111111111111122211111112111111211111122211121211111111111111121211111111121211111111111121111111111111111111111211111111111211111211
111111211121111111121211211111111111111111221121121111111111211112111111211112111121211211111121111111112111111111211111112112112111111211112211111211
121111112111112111111111221111121112111112112111111111121112111111111111111122111111111111111111111111111111111121111111111111111111111111111211111111
212111111111111111211111111111112111111111112111111111111111111211112112111112111121111121121221121112211111111111211121111111111111111111111111111121
111111111111111111111111111111111211111121111111111111211111112111111121111112121112111112121111112222211111111111122211111111111211221121111211111111
111112111121111111111111111111121111111111111111111111111111111111111111111121121211111111211111121111111111111111111112111111221111211111111111221111
122112212111111111111111211111111111111121111111211111211121112111111211111111211111111111111111112111111112111111111111111211111112211112121211111112
111111112122111111111111111111111111112111111211212112112111111121111111111111111111111111121111111111111111112121111111111111111111112111111111111211
111121111111111211111211112111111111111112111111111111111211111111111112111111111111111121111112211122212121111121111111111111211211111111111111112121
112221111111111111111211211111111111111211211121111211211211111111111111111112212111111111111112112112112111121121111111111111211111111111111111112112
112111122111111111121111111121111111111111211111111221111111121112211111111111111111111221111111121121112111121111121121121112211111111111111111111112
211111211111111111121211111111111211111111111122121211111111111111111111111211111211111111111111111111111111111111121111111121112111111111111111111121
111212111111112111111111211211111111111111111111111121111211211221111111121121111121211121111111121111111111111222111121111111111111121112111112121111
211211111111111111111111111111111111111111112211111111121121111111111111121211111111111111111121112121211211111211111111111121111111111111112111111112
112111211112111111111111211112111121111211211111111111112111111111111211211121121121112111111121111111111211111111111111111111112111211111111111111211
112112111111111112121111111111111111111121211211121111121211222112111111111121111111111111112111211112111111111111211211111111111111111111112111111111
111111112111111111111121111112111121111111111112111111111111111111111111112221111111111111111121111111111111112212111111111211111111121111111111111111
111111211111111111221121111111111111111121111111212221212111111112111111211111112111111111111111221111121211211111111111211122111211221111111111212111
111111111111111111111111111111211221111111111112111111111111121111111111111111111111111211111221112111211121111111111221111111111111111111111111121111
111211111111111111111112112111111111111111111111121111112111111111221111112111211111111111111112111111121121111111111111111111112111121111211212111111
111221121111112221111111211112111111121111121111111111111112111111111211111111111111211111111111111111111111111111111111111111111111121111111111111111
111111121121111112111111211111112111111111211111111111211111111111121112221111111112111111121111111111111111121112111111111111111111112111211121111122
111111112211111111211112111111112111111112121111211111111111111111111111111111221112111121111111111111111111121111111111211112111112111111112111111111
211111111111212121211211111111111111111111111211211122111112111111121111121111121111111112111111111111111111112112111111112111111111121211111211121111