000000000000000000000000000000000000000000000000000000000000000000000000000000000000000000000000000000000000000000000000000000000000000000000000000000
000000000000000000000000000000000000000000000000000000000000000000000000000000000000000000000000000000000000000000000000000000000000000000000000000000
000000000000000000000000000000000000000000000000000000000000000000000000000000000000000000000000000000000000000000000000000000000000000000000000000000
000000000000000000000000000000000000000000000000000000000000000000000000000000000000000000000000000000000000000000000000000000000000000000000000000000
000000000000000000000000000000000000000000000000000000000000000000000000000000000000000000000000000000000000000000000000000000000000000000000000000000
000000000000000000000000000000000000000000000000000000000000000000000000000000000000000000000000000000000000000000000000000000000000000000000000000000
000000000000000000000000000000000000000000000000000000000000000000000000000000000000000000000000000000000000000000000000000000000000000000000000000000
000000000000000000000000000000000000000000000000000000000000000000000000000000000000000000000000000000000000000000000000000000000000000000000000000000
000000000000000000000000000000000000000000000000000000000000000000000000000000000000000000000000000000000000000000000000000000000000000000000000000000
000000000000000000000000000000000000000000000000000000000000000000000000000000000000000000000000000000000000000000000000000000000000000000000000000000
000000000000000000000000000000000000000000000000000000000000000000000000000000000000000000000000000000000000000000000000000000000000000000000000000000
000000000000000000000000000000000000000000000000000000000000000000000000000000000000000000000000000000000000000000000000000000000000000000000000000000
000000000000000000000000000000000000000000000000000000000000000000000000000000000000000000000000000000000000000000000000000000000000000000000000000000
000000000000000000000000000000000000000000000000000000000000000000000000000000000000000000000000000000000000000000000000000000000000000000000000000000
000000000000000000000000000000000000000000000000000000000000000000000000000000000000000000000000000000000000000000000000000000000000000000000000000000
000000000000000000000000000000000000000000000000000000000000000000000000000000000000000000000000000000000000000000000000000000000000000000000000000000
000000000000000000000000000000000000000000000000000000000000000000000000000000000000000000000000000000000000000000000000000000000000000000000000000000
000000000000000000000000000000000000000000000000000000000000000000000000000000000000000000000000000000000000000000000000000000000000000000000000000000
000000000000000000000000000000000000000000000000000000000000000000000000000000000000000000000000000000000000000000000000000000000000000000000000000000
000000000000000000000000000000000000000000000000000000000000000000000000000000000000000000000000000000000000000000000000000000000000000000000000000000
000000000000000000000000000000000000000000000000000000000000000000000000000000000000000000000000000000000000000000000000000000000000000000000000000000
000000000000000000000000000000000000000000000000000000000000000000000000000000000000000000000000000000000000000000000000000000000000000000000000000000
000000000000000000000000000000000000000000000000000000000000000000000000000000000000000000000000000000000000000000000000000000000000000000000000000000
000000000000000000000000000000000000000000000000000000000000000000000000000000000000000000000000000000000000000000000000000000000000000000000000000000
000000000000000000000000000000000000000000000000000000000000000000000000000000000000000000000000000000000000000000000000000000000000000000000000000000
000000000000000000000000000000000000000000000000000000000000000000000000000000000000000000000000000000000000000000000000000000000000000000000000000000
000000000000000000000000000000000000000000000000000000000000000000000000000000000000000000000000000000000000000000000000000000000000000000000000000000
000000000000000000000000000000000000000000000000000000000000000000000000000000000000000000000000000000000000000000000000000000000000000000000000000000
000000000000000000000000000000000000000000000000000000000000000000000000000000000000000000000000000000000000000000000000000000000000000000000000000000
000000000000000000000000000000000000000000000000000000000000000000000000000000000000000000000000000000000000000000000000000000000000000000000000000000
000000000000000000000000000000000000000000000000000000000000000000000000000900000000000000000000000000000000000000000000000000000000000000000000000000
000000000000000000000000000000000000000000000000000000000000000000000000000000000000000000000000000000000000000000000000000000000000000000000000000000
000000000000000000000000000000000000000000000000000000000000000000000000000000000000000000000000000000000000000000000000000000000000000000000000000000
000000000000000000000000000000000000000000000000000000000000000000000000000000000000000000000000000000000000000000000000000000000000000000000000000000
000000000000000000000000000000000000000000000000000000000000000000000000000000000000000000000000000000000000000000000000000000000000000000000000000000
000000000000000000000000000000000000000000000000000000000000000000000000000000000000000000000000000000000000000000000000000000000000000000000000000000
000000000000000000000000000000000000000000000000000000000000000000000000000000000000000000000000000000000000000000000000000000000000000000000000000000
000000000000000000000000000000000000000000000000000000000000000000000000000000000000000000000000000000000000000000000000000000000000000000000000000000
000000000000000000000000000000000000000000000000000000000000000000000000000000000000000000000000000000000000000000000000000000000000000000000000000000
000000000000000000000000000000000000000000000000000000000000000000000000000000000000000000000000000000000000000000000000000000000000000000000000000000
000000000000000000000000000000000000000000000000000000000000000000000000000000000000000000000000000000000000000000000000000000000000000000000000000000
000000000000000000000000000000000000000000000000000000000000000000000000000000000000000000000000000000000000000000000000000000000000000000000000000000
000000000000000000000000000000000000000000000000000000000000000000000000000000000000000000000000000000000000000000000000000000000000000000000000000000
000000000000000000000000000000000000000000000000000000000000000000000000000000000000000000000000000000000000000000000000000000000000000000000000000000
000000000000000000000000000000000000000000000000000000000000000000000000000000000000000000000000000000000000000000000000000000000000000000000000000000
300000000000000000000000000000000000000000000000000000000000000000000000000000000000000000000000000000000000000000000000000000000000000000000000000000
100000000000000000000000000000000000000000000000000000000000000000000000000000000000000000000000000000000000000000000000000000000000000000000000000000
100000000000000000000000000000000000000000000000000000000000000000000000000000000000000000000000000000000000000000000000000000000000000000000000000000
130000000000000000000000000000000000000000000000000000000000000000000000000000000000000000000000000000000000000000000000000000000000000000000000000000
110000000000000000000000000000000000000000000000000000000000000000000000000000000000000000000000000000000000000000000000000000000000000000000000000000
110000000000000000000000000000000000000000000000000000000000000000000000000000000000000000000000000000000000000000000000000000000000000000000000000000
113300300000000000000000000000000000000000033000000000000000000000000000000000003300000000000000000000000000000000000000000000000000000000000000000000
111103100000000000000000000030000000000003011300000000000000000000000000000000301100330000000000000000000000000000000000000000000000000000000000000000
111101100000000000000000000310000000003001311100000000000000000000000000000003131100110300000000000000000000000000000000000000000000000000000000000000
111131130000000000000000030110030000001031111100000000000000000000000000000331111133113100000000000000000000000000000000000000000000000000000000000000
111111110000300000000000313113010000031011111130000000000000000000000000000111111111111100000000000000033030000000000000000000030000000000000000000000
111111110003130000000000111111313000311311111110000000000000000300000000003111111111111130000000000000011010000000000000000000310000000000000000000000
111111113301110000000003111111111030111111111110000000000000033103000000001111111111111110000000000000311313300000000000000000113000300000000000000000
111111111131113000000031111111111313111111111113000000000003311101330000031111111111111110033000330000111111100000000000000003111033100300000000000000
111111111111111000300311111111111111111111111111030303000031111131110000011111111111111113011030110303111111100000303003003001111311130100030003000000
111111111111111333133111111111111111111111111111313131333311111111113333311111111111111111311313113131111111133333131331331331111111113133313331333333
211111111111111111112111212111211111211111111121111111121111111112211111211111111111122111112111111121112111121111111111112111121211111111112111111111
211111111121211211111211111121111211211121111211111111211112112111111112121111211111112121111111111111111111111111111112111111111111112111111121111111
111111111111111111111111111111212111111111111121111111121121121111112121112111111111111111121111111111112112111111211111111111121111211211111111111111
111111212111111112121112121122111111111111111111211111112211111111111211111121111111112111211111111111111111112211111111111111111111112111111112111111
111211111111111111111121111111111112111212111111111111111111111111121111111111111111111111112111111111212111111111111221112112111111111111111111121111
111112111111111211111111111111112112112111111112111111111112112111111111111112111111112111221211111122121112121111112111111111111111111111121111111111
111211111111111112111111112111211111121121111212112111111111112121111111111111111111111121121111111111111111121121111111111111211111111211111121112111
111121111111112111111112111111111111111111111111112121111211112111111111111111111111121111111111112111111111111111111111111111111121112211111111111111
111111111211111111211111211111111121111111211111111111121111111112111111111111111111112111112112111121111211211111111111111121111111121111111112111112
111111112111121111121211111121111111111111112112111111111111111111111111111112111112111111111211111112112111221111111111111111111211111111111111122111
111121112211111111111122111111111111112121111111111111111211111121111112112111111111111121111111121222111211111111111111211111111111112111111111111121
211111111111111111111121111121111111111111111111121211111121111221111111111111211111111111111221111111121111112211122111111111111111111111111111112111
111111111111111121111211111111121111111112111112111111111111111111111111121111211121111111111121111121111111111111111112111221111111111111112111111111
111111111112121211111121111111111111111111111111111111111121111111111111121211111111111111211111111211221111111112111121112111111111111111122111111111
111111111211111121111111111111111111211111111111211121111121111111111112121111111111111121111211111211121111111111112111211221111111111112111211112121
121111111111111211111212211111111111121111111111111211111111121111121111122111111111212111111112211111211111111111111211111111111111211212112111111211
111111111211111111121111111111111111111211111121211211111111211111111111111111111111111111112111111111111112111111111111112111111111111111221111111111
111111211111111221111111212111111112112111111111112111111121111111111111111112122111111111111111112112111112111121112111111121121111111211111111221111
212111111211111111111111112111211111111111121211111111121111111121111111111111111111112121122111111111111111111111122112111122112111111111121112111112
111111111211111121111111111111112211111111111111111111111121111111111111121112111111112111111111111111111111112111111111111211112111111111112111121111
112111111111111111111111111111111112122111112211112111112111112111111121111111112121111111211111112112111111111111111112111211111212121111111111111111
121111111111111112111121111111111111211111111111111111111111212111111111111111111111111111221111111121111112111112111112111112111111112211111111121211
111111212111111111111111111111112121111111212111111111111111112111111211111111111111121111111111111111211111111121211121111111111111211111112111111111
111121111111121211111111211111111221111111111111121111111112111121121111111111111111211211111111111111111111111111111111211111121121111121211111111111
112211111211111111211121111112112111111121112111111111222111111121112111111111111111211212111112111111111121121211111111111111121111121111211111111111
211111111112111121111211112111111111211111111111111111111121111122111111121111111111111111111112111111211211111111111111211111122121111211111112221112
211111121211211211121111121211111111111111111112111111111121211111111112112112111111111111111121211111211111111111111121211111111111211111111111121111
111111111121211121111111111111111111111111111211112111121112211111122111111111211111111111121111111111111111111111111111111121111111221212111111112111
211111112111111111111112121211111111111111111121111111111111112212111111211111112111111211111111111111111112111111111111111111121111211221111111111211
121111212111111112111111111111111111111111111111111112111111112111111211112111111111211121112111211111111111111111211111121121111111111111111112112112
111122111211111211111111211111111112211211111121112111211111112121111111111121111121111111121111212112111111111212112121111112211121111111211121111211
111111112211111111111111112111211111112111111112111111121111121111111111111111121111121111111111111121111111111121111111112211211111111111211211111111
111111111111112221111112111111121111111111112111111121111111111112111111121111121111111111121111112111111111111112121112111111111111111111111211112112
111111112122111111111111111112111111111111112111112111111111112111211111211111211222211111111112211111112111112111111112211111112112112111121111111111
111111112111111111111111121111121111111111211212111111112111111111111121121111112111111121111111121111112111111121111211112221211121111111111111111111
211111111111112111111121111111111111111111111111121111111111111112211112111211211111121111111111121221111111111111111112211121111111211211111111111211
111111111121111111212111211121211211111121111111111111111111111111121111111111111121111111121111111111111211112111111111111111211112111111111212111111
111111111111111111111111111111211121211211111111111221111111111111122111111111111111111111111111112111111211111111111111111111112111111121111111211111
111111111211111111111111111112112111111112112211221212211111112111111111112211211111121122211211111111121111111111111111111111111111111221111111111111
111111111111111111111111111112111111111111121121111111111111111121111121111111111121111211111111121111111111121121111112111211211111111121111112111111
112111111111122111111111111111111121111111121111111121112211111111211111122111111111111111211211111111111111111111211111111111111111112112111111111111
112211111111111221111111111111121111121211111111111111111121111111111212111111111111211111111111111211112111111111211111111111111112111211211111122111
111111112111111112111111211121111112111111121111111111112111121111111111211121111111111111111112111111111111111111122111121111111111111111111121111111
111112111111111111121111211112111111111111111111112111111111212121111111112221121111111111111111111111111112111211111111111111111111112111122211111111
111111121112111111112112111122111111221111111211121112111111111111111111112111111111111111111111111111111111111121111111121112111111111111111111111121
211111211111111111111111111112111111112111211111111121111211211111111111111111111121111111111121111112121111111111211121112121111111111111111111211111
222121111111111211111111111121111212111111111111111211112211111111122222111111111121111111111211111111111111211111122111112111112211121121111121112112
111111111111112111111111111111111111111111111111111111112111112111221111111111111111111111112111211112112111111111111221111111111111111111111121112111
211111111121121111112111112111111111111111211111211112111121111112111111111111121111111111212111111111121111111111111111111121121111111111111111111111
111111122111111211111111111211111211111211211111111111111211111111112111111111111112111111111121111111111212111111111121112121111211111111212221111111
211111111111111111211111121111111111111111111111111122121111112111111211121111111112111111111111211111111111111111211111111111112111111211111211111112
111122121211112111111111112111111111112111121111111111111111111111111111111111111211111112111211211111111112111111111111111111111111121111121111111111
211112111111111111111111111111111211111121111111111111211111111111111111111111111111121111111211122111111111112112111211211121112111121111111111112111
111111111111111111111111111121211111111111111111111111111211111121121211111111111111111121121111111111111111111111111111211111111111111111111211111221
211111111111111122111211111111221111111111111221121111111111111112111111111111111111111111111112212111111111111112111111111111111111211121221111111111
111111221111111111111211111111111112111111111112111111111121111121111111112111111212111111111111111111121111111112111111111111111111111111111111111111
111111111111211211111111111111111111111111111112111111111111211112111121111211212111211111111121111111111111111211122111111111111111111211121111111111
111111111111112121111111112111111211121111111211111211112111111111121111111121111111111111111111111111211111211211112111111111111111111111211111211211
111211111111211111111111112111111211111122111211111111111111111111111211111111112111111111111112111111111111111111121111111111111111111121211111111112
112111211111111111111212212111111111122122111111121111111111112112112111211121211111111111111211121111112111112211211111111111111111111121111111111111
111111111111211111111121122111111111211122121111111111111111111111111111111111212111111111111111111111111121111111111211111111111111111111111112111111
111111121112111122111111112212111121111111111111111111111211111111111112111111121111111111112111111111111111111111111111222211211112111111111211111111
121111111111111111111211111111111111111111211111121121111111111111121111112111122111111111111121211111111121121122111112211111111111111211121111211111
112111121211111111111111111111121111111111111112211121111111111111111111121111111111112111121111111112111112211211111111211121111112121111111111111111
111111112111111111112112111111211221111111112211211111112111111111111111111121111111121111111111111111111211121111211111121111111111111111112111121111
111111211111111111121121111111111111111111111111111111112111111111111111111111211121121211111111111111111111112211111111111121111112111112112111111111
111111111221121111111111111111111111211211111112112112111111111111111111111112111111111111121111111121111211111211121111111111211111211211111121111111
122112221111111111121111111111111111111111111121111111121111111111111111112111211111111221111111111221111111111121111212211111111111212111111121111111
111211111111111111111111211212112111121111111111111121211111122111111111211111111111112112111111111111111221111122112111111112111112111111111111122111
111112111211211111111111111112111111121111111111111111211111111111111111121111111111112122111111121111212111211111111112111111111111111121111111112111
112111111212211111211122111111111122112211211211211111212211211111111121111111111211211121111111211111211111111121111111111111112111111111111111111121
111111111111111112211111111111111111111221112111111111111111111111211121112122111121111111111112111211221111111111111111111111121112111211111111111112
121111111111111121211111111111111111121111111221211211111111111211111111111111111111221111122111112211111111111111211111111121111112111211111111221121
111111112111111212111112111111111111221112111111111111111111212111111221111221111111111111111111211111211112111112111121111121111121111111212111111211
112111111111111111111111112111121111111111121111111111112111111112111111111111111122111111111111112111211211111111121112111111112111211112111111111121
111112111111111112111111211211111111111112111211121111111211111112111111111122211211112121211211111111111111111111111111111111111111111111112211111111
111111111122111111111111111111111111112111111111221111211111111111111211111111211111111111111111122111111121122111112111111111111111112111211111111211
111112211212111221121111111111111111212111221111211121111111211111111111121211111111111111111111111211111111111111112121111111211111111111111111112211
111111111111111121111111211111112111211111122111111111111111111111121121111112211111112111212211111211111111111111112111211111211211112111111222111211
111121211111111111111111212121121111121211111111111111121111111111111111121111122112112111211111111112111111111111111111111112111111111111111111111211
111111221111121211212111111111112111121112111111111111121111111111111111111121111111111211121111111111211111111121112112111121111111111111112111111121
111111111211111112211111212111212111111111211111111111111111121211111211211111111111111112111111111111111111111111111111111111111121111112122111211111
112111111111111111112111111211111111111111111111112121121211211111121112111112111121111111111111111111211111122211111112111211111111121211111112111111
211121111121111121112111111111111121112221111111111111111111111111111111111211111111212121211111111111111211111111111121111112121111122211112111111111
112111111111112111111111111111112111111121111111121111111211112111111111111111111111111112212121121121111211111121211111211212111211111211111111211111
111111111111111111211222112122111111121111111112111111111111111121111111121111121111111111112111122112111211111111111121111212111111111111111111111111
211111111111111111121211111121111111111111111111111111111111112111111111111111112111111112112211112111112111211111121111111111111111111111221111111212
111211112111122111111121111111111112111111111111111112112111111111111111111111111121111112112112111111111111111111211111112211111211111111111211111111
111111111111112111121211111111212211111111122111111121111111121111111111111111111111111111112111111211211212111111111211112111111211111111111111121111