000000000000000000000000000000000000000000000000000000000000000000000000000000000000000000000000000000000000000000000000000000000000000000000000000000
000000000000000000000000000000000000000000000000000000000000000000000000000000000000000000000000000000000000000000000000000000000000000000000000000000
000000000000000000000000000000000000000000000000000000000000000000000000000000000000000000000000000000000000000000000000000000000000000000000000000000
000000000000000000000000000000000000000000000000000000000000000000000000000000000000000000000000000000000000000000000000000000000000000000000000000000
000000000000000000000000000000000000000000000000000000000000000000000000000000000000000000000000000000000000000000000000000000000000000000000000000000
000000000000000000000000000000000000000000000000000000000000000000000000000000000000000000000000000000000000000000000000000000000000000000000000000000
000000000000000000000000000000000000000000000000000000000000000000000000000000000000000000000000000000000000000000000000000000000000000000000000000000
000000000000000000000000000000000000000000000000000000000000000000000000000000000000000000000000000000000000000000000000000000000000000000000000000000
000000000000000000000000000000000000000000000000000000000000000000000000000000000000000000000000000000000000000000000000000000000000000000000000000000
000000000000000000000000000000000000000000000000000000000000000000000000000000000000000000000000000000000000000000000000000000000000000000000000000000
000000000000000000000000000000000000000000000000000000000000000000000000000000000000000000000000000000000000000000000000000000000000000000000000000000
000000000000000000000000000000000000000000000000000000000000000000000000000000000000000000000000000000000000000000000000000000000000000000000000000000
000000000000000000000000000000000000000000000000000000000000000000000000000000000000000000000000000000000000000000000000000000000000000000000000000000
000000000000000000000000000000000000000000000000000000000000000000000000000000000000000000000000000000000000000000000000000000000000000000000000000000
000000000000000000000000000000000000000000000000000000000000000000000000000000000000000000000000000000000000000000000000000000000000000000000000000000
000000000000000000000000000000000000000000000000000000000000000000000000000000000000000000000000000000000000000000000000000000000000000000000000000000
000000000000000000000000000000000000000000000000000000000000000000000000000000000000000000000000000000000000000000000000000000000000000000000000000000
000000000000000000000000000000000000000000000000000000000000000000000000000000000000000000000000000000000000000000000000000000000000000000000000000000
000000000000000000000000000000000000000000000000000000000000000000000000000000000000000000000000000000000000000000000000000000000000000000000000000000
000000000000000000000000000000000000000000000000000000000000000000000000000000000000000000000000000000000000000000000000000000000000000000000000000000
000000000000000000000000000000000000000000000000000000000000000000000000000000000000000000000000000000000000000000000000000000000000000000000000000000
000000000000000000000000000000000000000000000000000000000000000000000000000000000000000000000000000000000000000000000000000000000000000000000000000000
000000000000000000000000000000000000000000000000000000000000000000000000000000000000000000000000000000000000000000000000000000000000000000000000000000
000000000000000000000000000000000000000000000000000000000000000000000000000000000000000000000000000000000000000000000000000000000000000000000000000000
000000000000000000000000000000000000000000000000000000000000000000000000000000000000000000000000000000000000000000000000000000000000000000000000000000
000000000000000000000000000000000000000000000000000000000000000000000000000000000000000000000000000000000000000000000000000000000000000000000000000000
000000000000000000000000000000000000000000000000000000000000000000000000000000000000000000000000000000000000000000000000000000000000000000000000000000
000000000000000000000000000000000000000000000000000000000000000000000000000000000000000000000000000000000000000000000000000000000000000000000000000000
000000000000000000000000000000000000000000000000000000000000000000000000000000000000000000000000000000000000000000000000000000000000000000000000000000
000000000000000000000000000000000000000000000000000000000000000000000000000000000000000000000000000000000000000000000000000000000000000000000000000000
000000000000000000000000000000000000000000000000000000000000000000000000000900000000000000000000000000000000000000000000000000000000000000000000000000
000000000000000000000000000000000000000000000000000000000000000000000000000000000000000000000000000000000000000000000000000000000000000000000000000000
000000000000000000000000000000000000000000000000000000000000000000000000000000000000000000000000000000000000000000000000000000000000000000000000000000
000000000000000000000000000000000000000000000000000000000000000000000000000000000000000000000000000000000000000000000000000000000000000000000000000000
000000000000000000000000000000000000000000000000000000000000000000000000000000000000000000000000000000000000000000000000000000000000000000000000000000
000000000000000000000000000000000000000000000000000000000000000000000000000000000000000000000000000000000000000000000000000000000000000000000000000000
000000000000000000000000000000000000000000000000000000000000000000000000000000000000000000000000000000000000000000000000000000000000000000000000000000
000000000000000000000000000000000000000000000000000000000000000000000000000000000000000000000000000000000000000000000000000000000000000000000000000000
000000000000000000000000000000000000000000000000000000000000000000000000000000000000000000000000000000000000000000000000000000000000000000000000000000
000000000000000000000000000000000000000000000000000000000000000000000000000000000000000000000000000000000000000000000000000000000000000000000000000000
000000000000000000000000000000000000000000000000000000000000000000000000000000000000000000000000000000000000000000000000000000000000000000000000000000
000000000000000000000000000000000000000000000000000000000000000000000000000000000000000000000000000000000000000000000000000000000000000000000000000000
000000000000000000000000000000000000000000000000000000000000000000000000000000000000000000000000000000000000000000000000000000000000000000000000000000
000000000000000000000000000000000000000000000000000000000000000000000000000000000000000000000000000000000000000000000000000000000000000000000000000000
000000000000000000000000000000000000000000000000000000000000000000000000000000000000000000000000000000000000000000000000000000000000000000000000000000
300000000000000000000000000000000000000000000000000000000000000000000000000000000000000000000000000000000000000000000000000000000000000000000000000000
130000000000000000000000000000000000000000000000000000000000000000000000000000000000000000000000000000000000000000000000000000000000000000000000000000
113300000000000000000000000000000000000000000000000000000000000000000000000000000000000000000000000000000000000000000000000000000000000000000000000000
111100000000000000000000000000000000000000000000000000000000000000000000000000000000000000000000000000000000000000000000000000000000000000000000000000
111100000000000000000000000000000000000000000000000000000000000000000000000000000000000000000000000000000000000000000000000000000000000000000000000000
111133000000000000000000000000000000000000000000000000000000000000000000000000000000000000000000000000000000000000000000000000000000000000000000000000
111111000000000000000000000000000000000000000000000000000000000000000030000000000000000000000000000000000000000000000000000000000000000000000000000000
111111000000000000000000000000000000000000000000000000000000000000000013000000000000000000000000000000000000000000000000000000000000000000000000000000
111111300000300000000000000000000000000000000000000000000000000000003311000000000000000000000000000000000000000000000000000000000000000000000000000000
111111130030100000000000000000000000000000000000000000000000000003001111300000000000000000000000000000000000000000000000000000000000000000000000000000
111111113013100000000000000000000000000000000300000000000000000001031111100000000000000000330000000000000000000000000000000000000000000000000000000000
111111111311130000000300000000000000000003303100000000000003003331311111100000000000030330113330300000000000000000000000000000000000000000000000000000
111111111111110000003100000000000000000001131100000000000001301111111111130000000000310113111113103000000000000000000000000000000000000000000000000003
111111111111110000301100000000300000003031111130000000300331131111111111110000000003113111111111101300000000330000000033000000000000000000003000030001
111111111111113330131130000030133000031011111113003300100111111111111111110300030001111111111111131100300000113300003011000000300030003000331000010031
111111111111111113111113333313111333311311111111331133133111111111111111113133313331111111111111111133133333111133331311333333133313331333111333313311
111121111111121111211121122111221121111112111111111112111111111112111112211111111111112121111111111221111121111112111111111211111111111111111111111112
111111112111211111111121111112111111121111112111121112111111111121111111111111211221112111111111111211112111111111111111111111111111121112111111121111
111211111111111121111121111111111121111211111112111111111111121111112111121112111111111112111121122111111112111222221111111112211111211121111121111121
111111111111111111111111111111111111122112111112111121111111112111111121212121121111111111122111112121111111111111111212111111211122111111222111111111
221111111112121121111211112121111112112111121111112111111212111121111111111111112111211111111112111112111211211111121121111211111112111112111111111212
121212111111211211111212121111111211111211112111211111111111111111111121121111111122111112121111111111111111111112111111111111111111111111111121111121
211112111111111211111111211111111121111111211111121111111111111111111111111121212111111111121121121111111111111111111111122111111112111111121112121111
111111112111112111111111111121111111121111111212111111111111111111121111211111111111111111111112111112111111121121111111111112111211121111121111111111
111112211111121112111112121211112111111111111111111111121111111111211111111111111111112111111111112111111122111111111111111111111111111111111111111111
111111111111221111111211111111112112112111211111111121111111211111221111111212111211211211112212111111211111211121111111111112111111211111111111211111
211112111111111121111112111111111111212111111211111111111111221111111112111111111112111111111121111111111111121111121112111111221111112111221112111111
211111111111111112211111111211121112111111111112111112211111111211111111111111112121111211111221111111112111111111111111111111111111111111111112112111
112111111111111111111111111111111112111111111211111112111111111111111112111112112221111111111111111122111111121111111111111212112121111111111111111121
111111112121211111121111111111211111111111111111111111121111121211111111111211111111111111111111111111111211111211121112121211111211111111111111111112
212111112111121121111111112112111111111112111121111121121111111111211111112111111111111111111111211111111111111111211111112111111111111111211121111111
111121111111111111111111111121211111111112121111112111111111111111111111112211111111111211111111111111111111111111121111111111111211111211121112111111
111111111111111111111111111111121122111111121111122122211111111111111211111111111111112211111211111111112121111111111111111111111111121111111111111112
112221112121111111121211111111112211112112221111111111211111111211111211111112121211111111112112111111111111111111111111111111111111121111211111121111
111111111111111111111211111111211111111111121111211111111111111211111111111111111111121112111212221111111111111111111111111211112111112111111111111121
111111122211111111111111111111111111111211111112111111111111211111221121111112112111112111111111111111111111121111111111112211211111221111111121111112
221111111111112111211111221211221111112111111112111121112121211221111111121111211112211112112112111111111111111111111121111111111111111112111111111211
111111121221111111112211111111111111111111112111111111111111112111121111211111112111111111121111211112112111111112111112111111112111111111111111111111
111111121121121111121111111111111111111211121112111111111211122121111111211111111111111111111111111111121211121112111111111111121111111111121121112111
111111111121111111111111111221111211211211111111111211111111111111111112111111111111111122111212111111211211112111111111121111111211211111111111111111
111111121111111112111111212112121111111111111221111111111111111121111111111111111111111111111111111111111111111111111112111111111112212212211111121111
111112121111111111112112111111111111111111111112111111211111111112111111111112222111111111111111111221111111121111111121121111111211111111211121111121
111112211111111111111111111111211112211211111111111111121111111211111112211111111111111111121121111112111121121121111112112111212211111111212111112111
111211111121112111111121112111111111111211111111111121211111121211111211211111111111111112212111111111111121111111111111121111112121111111121111111112
111111112211111121111211111111111111111112111111111111111111111211111111111111111112111111111111111111111121111112111112211112211111122111111111111111
212121111111111111121111211111122111111112111111112111111112111111112121111111211111111111112111111121111211111111111111211111111111112111111111111212
121111121111111111211122112111111111111111111112111111221111111111121111111111111112111111111111111112111111111111112112112211111111112111112111111111
111111211111121121112111111111211212111111122112111121111111211121111111211111111111211111112111111111111111111111121111111111111121112111112111111111
111111111111111122111112111111111211111111111111111111112121111211111111112121111111111121112111111111211111121111112112112121111211221112212111112111
111111111111211111112211111121111111111111211111112111211112111111121111121111121111111111111211111111111111121111111111111111121121212111211211121111
111111111111111121111111211111111111111111112111111111111121111111122112211211111111111111211111111111111111111111111121121111121111111111111111111111
221121121111111211121112121111111211111111111111111121212111121111111111111111121111111212111121121111111111112121211221111111112122111121221111111111
122111112211121112111112111121211111112111111111121121111111121111111111111111111111111111111111111111221111111121112211111121111111111111121111111211
211111111112111121111111111111111111111112111111111211111111111111111211111111122212111111111111121111111111111212111111111111111111111121111111121111
111111121111111112111211111111111121111111111111111121112111112112112121111111111121112122111111111111111121111111111111111111111111111111111111212111
111111111111111111111111111111111111112111111111211111221111111111111111121221111211111111111111211112211121211111111111111111111211111111111211111111
111111111111121111111112111111111111111111122111111211121112111121121111111111111111111111111111211112111111211121221112111111111211111111121111111211
111121111111111111111111111111211111111111121211111111112111111111111111111211111111112111111111111111111111121112111111211211111111112211111111211111
111111112111111111111111111111211221111112111111111112111111112111111111211111111121121111112111111111111111111111211112211111111211111111111111111122
111111111111111112112111111111111111111111211112111111111221111111111111111111111111111211111211211111111111121111111111111211112111112111111121111111
111112111111111111221111111111111211111111112111111211111121211111111112211111111121111111122211111121111111111111112111111111112111112111111111111111
111111111211211121211221111111111211111111112111111112121211111111111111112111111111212211111111111111121111111112111211111111112111111112112111121111
111111211111111211112111112111111211121111211121111111111111111112111121112112111111111111111112121111111111211111122121122211112111211222122121112111
212111111111211111211111111221111111111111111111111111111111111121111111111211111111212121111111112211121111121111112211221211111111111121111211212111
111111211111111111111111111211112111111111111111111111111111112112111111211111111111111111211112111111111121111121111211211122111111111122111112111212
111111111111111111111112111111111111111112111111122111111112111111211111111121121211111211121111111111111111211121111111111111112111112112121111111121
111111111211111111111111111111111111211111121121111111121111111211112111112111121111121112111211111121111121212111121111121211112111111111111211111111
211111111211121112111111111111111211111111111112111111111121111111111111111121111111211111111111111211121121211111111111121111111121111121111121212111
111111211112211121111112111111121111111121111121111121111111111111112111211111121111121211111211212111211111111122111121111212211121111111211121111211
211111121111112211111111112111111111111111211111121212111111111111111111112111121111112111111111111111111111111112111111111111112111111111111112111111
111121211211111111112111112111111211111111111111112111111121111111121111111121211111121121121111111111112111211112221111112111111121211111111111111111
111111111111121111122221111111111111111111111111111221112111111111111111111111211111111111121111111121111111111212111111211111211111111111111112111111
111111111111111111111111121112211111111121221111111111111111111211112111111111112111111211111112122111111111111111111111111111122111121211111112121111
111112211111211121211112111211111121111111111111111111111111111212121111111211121111111111111111111111111111111112111111111111111111212112111111212111
121111211111121112111111111111111111111121111111211111121111211121111112211122211112111111111111112111111111111211111211111111112121112111111111121111
111111111111111111211111211121121111111121111111111111111121121121111111121111111111212211111111121111111111111111111111211211211111111111111112211111
111111111111112111111111121111111211111112111111211111111111111122111111111111111212111211111111121111111212111111211111111211111111111111211121111111
221211211111112111111111111111111111221111121112121121112112111111112122121111122212111111111112221111111111211111112211112211111111112111222111111111
111112111111111111111112111121111211211112111111121111211112111111112111111111111111211111211111121111111211111111111111211111211111111111111111111111
111111111121111111111121111112111111111111111111121111121111121111111112111111111111211111112111211111211111111111221111111111211111111111211211111111
121111111111111111211111111112112111122111111111111111112111111121112122111111112111211211111111211112112111111111111111121111111111111112111111121211
112111111111211111111121111111111111121111111122211211112111211111111112111111111112111111121121111122111211222121111111211211111111221111111112211111
111111111112111111121211111111111212211111112111112111111112111111111221111111111111111111111111121111211111111211112111211221111111111211111111121112
112121121111111111121111111111111111111211111111211111111111111221121212111111111111111111121211211111111211111111211112111111121111111111111111121111
111121111111111111112111111121111112121111111111111111111111211111111111111111121211111111111111112112111111111211111121111111121222111111111111111112
121112111111221111111111111112111111211111111111111111112121111112112111121112111111112111112111111111111121111122111111211111211211122121211111111121
111111121211111111111111112111111121111111111111111121211112111121111111112111111111111111111111111112112211112111112111111111111111211111111111112111
111111112112112111111211211111111111111111111211112111211111111112111111111111111211111112111111111111111111112111112111111112111111111111111121111221
121112211121111111111112111112111111111111111111112111111111122111111211121111111111111111111121111121111111111111121111111111111111112111111111111111
111111111111111111111111111112121121211111111111111111111111111111121111111111111111111111111111112111211121111111111111111111111111111211111112112111
111111111122111111111111111111112121112111111111121211111111211111111211111111111111212111112211111111111112111121112111111112111111111211211111111111
111111111111112211111111111111111212111111211111111111111111111111111111111111121111212111112111111111211111111111112111111111111121111111112111111111
112111111111111111111111112111112111111211211111111111112111112111111111111111211111211111112111112211111112121111111111111111121111111111111111112121
111111211111111211121112211211112111111211211112121111122111111111211211211111111111212111211121111111112111111111211111111111121111111111211111111111
111111121122111111122111111111211111112111221111111122111211111111112112111111122111111111111111111221111121121111111111112111111211111111111111111111
111111111111111121111111122111111111111211211111111121111211111111111111111111111211111112211111111111112111112121111111211211211112112122111111111111
122111112111211111111111111111111111111111111121111211111111111121111111111111112211111121111111111111111111111211111112111111111112111111111211112111
111121111111121112111111111211111112111111121111111121211111111111112121111111111111112111111111111111111121121121111121111111111111111112111211111112
111111111211111111221211111111111211111111111211111111211111111111111111111111111111111111111111111111121111111111212121221111121112111112121111111111
111111121111111112111111111111111111111111112111111111111112111111122111111111111111111111111211111111111211111111111211111111111111221122111121111212
211111111111121112111111111121121111111111111111111112121111111211111111111111111111112112111121211111111111111221111111111111121111111111111111121121
111111121111111221111111111112121111111111111111121111112111111112121111111111211211111111111111211111111111111112111111111112211111112111112111111111
111111121111111111111111212211121121111211111111111112111111111112111111121111112112112111111111111111111111112111212111121111111111111111111111111111
211111111111111111111112111111221111111111111111111211111121111111111111211111111112111112111111121111221221111211112121111122111111112111112111111111
111111121111211111111121121211111211111111111111111122111111211111111111111111211111111212111111111111111211111112121211111111111111111111112111211211