000000000000000000000000000000000000000000000000000000000000000000000000000000000000000000000000000000000000000000000000000000000000000000000000000000
000000000000000000000000000000000000000000000000000000000000000000000000000000000000000000000000000000000000000000000000000000000000000000000000000000
000000000000000000000000000000000000000000000000000000000000000000000000000000000000000000000000000000000000000000000000000000000000000000000000000000
000000000000000000000000000000000000000000000000000000000000000000000000000000000000000000000000000000000000000000000000000000000000000000000000000000
000000000000000000000000000000000000000000000000000000000000000000000000000000000000000000000000000000000000000000000000000000000000000000000000000000
000000000000000000000000000000000000000000000000000000000000000000000000000000000000000000000000000000000000000000000000000000000000000000000000000000
000000000000000000000000000000000000000000000000000000000000000000000000000000000000000000000000000000000000000000000000000000000000000000000000000000
000000000000000000000000000000000000000000000000000000000000000000000000000000000000000000000000000000000000000000000000000000000000000000000000000000
000000000000000000000000000000000000000000000000000000000000000000000000000000000000000000000000000000000000000000000000000000000000000000000000000000
000000000000000000000000000000000000000000000000000000000000000000000000000000000000000000000000000000000000000000000000000000000000000000000000000000
000000000000000000000000000000000000000000000000000000000000000000000000000000000000000000000000000000000000000000000000000000000000000000000000000000
000000000000000000000000000000000000000000000000000000000000000000000000000000000000000000000000000000000000000000000000000000000000000000000000000000
000000000000000000000000000000000000000000000000000000000000000000000000000000000000000000000000000000000000000000000000000000000000000000000000000000
000000000000000000000000000000000000000000000000000000000000000000000000000000000000000000000000000000000000000000000000000000000000000000000000000000
000000000000000000000000000000000000000000000000000000000000000000000000000000000000000000000000000000000000000000000000000000000000000000000000000000
000000000000000000000000000000000000000000000000000000000000000000000000000000000000000000000000000000000000000000000000000000000000000000000000000000
000000000000000000000000000000000000000000000000000000000000000000000000000000000000000000000000000000000000000000000000000000000000000000000000000000
000000000000000000000000000000000000000000000000000000000000000000000000000000000000000000000000000000000000000000000000000000000000000000000000000000
000000000000000000000000000000000000000000000000000000000000000000000000000000000000000000000000000000000000000000000000000000000000000000000000000000
000000000000000000000000000000000000000000000000000000000000000000000000000000000000000000000000000000000000000000000000000000000000000000000000000000
000000000000000000000000000000000000000000000000000000000000000000000000000000000000000000000000000000000000000000000000000000000000000000000000000000
000000000000000000000000000000000000000000000000000000000000000000000000000000000000000000000000000000000000000000000000000000000000000000000000000000
000000000000000000000000000000000000000000000000000000000000000000000000000000000000000000000000000000000000000000000000000000000000000000000000000000
000000000000000000000000000000000000000000000000000000000000000000000000000000000000000000000000000000000000000000000000000000000000000000000000000000
000000000000000000000000000000000000000000000000000000000000000000000000000000000000000000000000000000000000000000000000000000000000000000000000000000
000000000000000000000000000000000000000000000000000000000000000000000000000000000000000000000000000000000000000000000000000000000000000000000000000000
000000000000000000000000000000000000000000000000000000000000000000000000000000000000000000000000000000000000000000000000000000000000000000000000000000
000000000000000000000000000000000000000000000000000000000000000000000000000000000000000000000000000000000000000000000000000000000000000000000000000000
000000000000000000000000000000000000000000000000000000000000000000000000000000000000000000000000000000000000000000000000000000000000000000000000000000
000000000000000000000000000000000000000000000000000000000000000000000000000000000000000000000000000000000000000000000000000000000000000000000000000000
000000000000000000000000000000000000000000000000000000000000000000000000000900000000000000000000000000000000000000000000000000000000000000000000000000
000000000000000000000000000000000000000000000000000000000000000000000000000000000000000000000000000000000000000000000000000000000000000000000000000000
000000000000000000000000000000000000000000000000000000000000000000000000000000000000000000000000000000000000000000000000000000000000000000000000000000
000000000000000000000000000000000000000000000000000000000000000000000000000000000000000000000000000000000000000000000000000000000000000000000000000000
000000000000000000000000000000000000000000000000000000000000000000000000000000000000000000000000000000000000000000000000000000000000000000000000000000
000000000000000000000000000000000000000000000000000000000000000000000000000000000000000000000000000000000000000000000000000000000000000000000000000000
000000000000000000000000000000000000000000000000000000000000000000000000000000000000000000000000000000000000000000000000000000000000000000000000000000
000000000000000000000000000000000000000000000000000000000000000000000000000000000000000000000000000000000000000000000000000000000000000000000000000000
000000000000000000000000000000000000000000000000000000000000000000000000000000000000000000000000000000000000000000000000000000000000000000000000000000
000000000000000000000000000000000000000000000000000000000000000000000000000000000000000000000000000000000000000000000000000000000000000000000000000000
000000000000000000000000000000000000000000000000000000000000000000000000000000000000000000000000000000000000000000000000000000000000000000000000000000
000003000000000000000000000000000000000000000000000000000000000000000000000000000000000000000000000000000000000000000000000000000000000000000000000000
000331000000000000000000000000000000000000000000000000000000000000000000000000000000000000000000000000000000000000000000000000000000000000000000000000
033111000000000000000000000000000000000000000000000000000000000000000000000000000000000000000000000000000000000000000000000000000000000000000000000000
011111330000000000000000000000000000000000000000000000000000000000000000000000000000000000000000000000000000000000000000000000000000000000000000000000
311111113000000000000000000000000000000000000000000000000000000000000000000000000000000000000000000000000000000000000000000000000000000000000000000000
111111111030000000000000000000000000000000000000000000000000000000000000000000000000000000000000000000000000000000000000000000000000000000000000000000
111111111013000000000000000000000000000000000000000000000000000000000000000000000000000000000000000000000000000000000000000000000000000000000000000000
111111111311000000000000000000000000000000000000000000000000000000000000000000000000000000000000000000000000000000000000000000000000000000000000000000
111111111111300000000000000000000000000000000000000000000000000000000000000000000000000000000000000000000000000000000000000000000000000000000000000000
111111111111130000000000000000000000000000000000000000000000000000000000000000000000000000000000000000000000000000000000000000000000000000000000000000
111111111111113333000000000000000000000000000000000000000000000000000000000000000000000000000000000000000000000000000000000000000000000000000000000000
111111111111111111330000000030000000000000000000000000000000000000000000000000000000000000000000000000000000000000000000000000000000000000000000000000
111111111111111111113000003010000000000000000000000000000000000000000000000000000000000000000000000000000000000000000000000000000000000000000000000000
111111111111111111111000031313030000000000000000000000000000000000000000000000000000000000000000000000000000000000000000000000000000000000000000000000
111111111111111111111303311111010000000000000000000000000000000000000000000000000000000000000000000000000000000000000000000000000033030000000000000000
111111111111111111111101111111310000000000000000000000000000300000000000000000000000000000000000000000000000000300000000000000003311310000000000000000
111111111111111111111131111111113330000000000000000000000000100000000000000000000000000000000000000000000000000100000000000000031111110000000000000030
111111111111111111111111111111111110000003000000030000000003100000300000000300000000030000000000003003000300033100300000000300311111113003000000000310
111111111111111111111111111111111110330001000000313033303301130000100300000100003003313000000000301001000100011133133000003130111111111001300030000113
111111111111111111111111111111111113113331333333111311131131113333133133333133331331111333333333131331333133311111111333331113111111111331133313333111
111221111221121111112111121111111111111111111111121111121121111211111111111112122112112111121111112111111111121112111111111111111111111111111211111212
112111111112111112111111111111111111112111111221111211111111211211111111111111111111111112111111111111112111111111111111122211112111111111112111111111
111111111111111211111111111112112111111111111211111111111111111111111111112111111212111111111111111111111111111121112121111211212111111211111112111111
111112111111111111121111211111111111111111111111121211112111211111111111111111111112211111212112111112111111111111111111111111111211111111111111111111
111111211121111111111111111221111111111211111111111121111111111112211111111111111212121112111211111111111111121221111111111121111111221111211111221111
111111111111112111211111121111111111111221111111121121111111111112112111221211111111111112121111111112211111111111211111111111111112111111211211121111
111112111111111111211112111212111112111111111111111111111121112111111111111212111112111111111121111111111112111111111121111112111111111121111111112111
121111112212111111211111111111121111111111111112112121111111112111111111112211211211111111111211111121111211121111111211111211111121111112111111111111
111211111111111121121111111111112111111211111211111111111111211111111111112111111111111111111111111111111111121111121212111111121111121111211111111111
111111112111111111111111111111111111211111122111111111111211112111111111211111111211121111111111111211211211111112111121111121111112211111211112111111
111111111112211121111111111111111111111111111111111111111112221112111121111121211111111111111111211211121211211111211111111211111111222111121111212111
111111111211111111111112111111111111111112111111112111211111121111112111211212211211111111111112111111111111111111111111111111111111111111111111111111
111111111121111111111111211111112111112111111111111111111121111111112111121111111211111111111121211111111111111112111111211111111111111111122211111111
111121111112211121111112111121111111121211111111111111111111111111122111111111111122111121111111111111111112111111112121112111111111111111222111111111
111111111211121111122111221111111112121111111111111111112112111111112121111111111111111112211111122121121111111111111211111111111111211121121121111111
112111111112111111112121111111112111212111111111111111121212111111111112112121111111112111121111111111111122112111111111111111112121111211111111111111
111121221111111111111121111112111111122121112111112111211111112112211121121111112111211111112111111111121112112111111122111111111111111111111212111111
111212211111211111111121111212111111111111111121111111112111111111211111111111211111111121111111111111112112111111111111111111111111111121112111111111
111112211211111122111121111211111121111111111111221211111111121212211111112111211112111111111111122112111111112111111111211111121112122111111211111111
212111111112121111121121111111111121211111111121121111121111111111211111211111111112111111111111111111211111211111111111211112212111211121111111111121
121111111211111111111111111111121111111121111111221111111111111112111111211111112111111211212111121111111211111211211211112111122111111121121111111111
211111111111111111111111111211211111111122111121111121111111111112111111111112111111121121111212112111111121112112111111111111121111221212111111111111
111111111111111111111211111121122112111111111121212111111111121111211112111112111121111111111111121112111211111111111111122112111111111211111111111112
111111111112112112111111111111112111221211211111222221111111111111111111111111111111111111111111111121111111111111111111211112111111111111111111211111
111111111111111121111111111111111111121211112112121111211211111111111111211111111111111211111121211111111111111111111111111111211111111111121111111112
112112111111112111112111111111111111111111111111111211112211112111211111122121211111122111111111111111111111121122121111111111111111111111111112121111
111111111111111111111111211111112111112112111111121111111111111211111112121111122111221122111112212121111111211112111121111111111111111111111211111121
111121111121111111111111212112111112111121111111111111111211111111111211111111112211111211111211211111211111111111111111111111111121111111111111211112
111111111111111112111121112111111121211111211111111111211111111111111212111111121111111111111111111111112111211121112211111111111111111212121211112111
111111111111111111221121111111111111111111111111111111112111111112211111111111111121111112111111111112122111111122111111121111111121111111111111121122
211111121211111211112211111122112112111111121112111111111112111111111111111121211112211111211121111111111111111111112111121111111111111111111112111111
111211111111111211111111111111111111112121111111111211111121212112111111111111111111111112111112211111211112111211111121111111121112111111111121211111
111121112111111211111111221111111111111111211111211111122111111111111112112111111111111111221111121111111111111111112121111112111121111111111211111111
211111111111211111111111111111111111111121212111111111111121111111111121111111111211112111111111111111121211211212111111111111122212111112111111111111
111111111211121211111111111211121111111111111222111111111112121111111112111112111111111121111121111112111111111111112211111121111111211111111111111111
111111121111111122121111121111111111111211111111121111111111221111112111211111111111111211111121111112112211111211111111112121211111111111211211111121
111211111121121112111122111111112111211111112211111111111111111111111111111111211111111111112112111111111111112111112112121111111111211111111112111111
111111121111111111111111111111121111112111111111221211111111111111211111111121121111221111111211221111111111111212112111112111111211111111111221111212
111111111111111111121111111111111111111211111111221211111111111111121112111221111122111111111111111111121211111111121121111111111111221111111121121111
111111111111111111111111111111111121111111111111111111111111111121212111111111211111111121112112121111121111111211111121211111111111111111111111111112
111111111211111212111112111111111111111111112111111111111111112111121111111111221111111121112111212111111211111111122111111122111112112111111112121111
112111111221111111111111111111111111111111111112111111111121111111111211121111111111121111111111211212111111211111211212111112111111111221111111211111
111111111111111111111111112112111112122111111112112111211211111211111121111111111211111112111111111111111111111111111111211212112111121212111111111111
111111111112111211111111111211111112111111111111211211111111111111111122111111111111121111121111111111111111111111111111211111111111111111111111111211
111111111111211121111111111112111111211111112121111121111111111111111111111111111121112111111112111111111121111121111111111111111111211111111121121111
111111111111121211211111111111111111111111111221211111111121111211111111111111111111211111121111211221211111211111111111111111111121111111111111111111
111211211111121111112111111111121121111111112111111212211111111111111111112111121111111112111112111111111111211111112111111111111211111111111121112111
111111111211111111111111111111121111122121112111111111111111111111111121111112111111111111111112111111112111211111111111211221111111111111121111111121
121121111111121111111111111111111111111111111111211111111111111112111111111111111111111212111111111211111211111222111111111111121111111211112122111111
111111112111111211111212111122111111111111111111111111111111111111111211121111111211111112121111121211112121111112111221221111111111111121111111111111
121111112121121111111111111111111121111211111111121111121112111121111111111112121111211121111111211211112111111111211121112211211111111112112211111111
111111111112211111111112112111211111111111112211111111111112111111111111111121111211111111211111111112121111111111112212111222111111111111111111111111
111211121111111121121111121211112111111111111121111111111111122111211211111111111111111211111121111111111121111111111111111111111121121111111122221112
112111112111121112211111111111111111111211112111111221121111111121111121111211111111111112111111112111111111111111111111111211221121111211111111111112
111111111111111111111111111111211111121111111211222111111111121111112111112111211121111121221111121111112111111111121111111111211111111211121111111111
121111111121111111111111211111112211121111211111122211111221111111211111111111112111112111211111111112211111112111111111121111111121111111111111122112
121211111111111111111111111111112111112111112111112211111111121111111111111111111111111211122211111111112111111211111112111111111111111211121112112211
112111111111111111211211211111111112111111111121111222111111121111112111211111111112221112111211111121111111111211111111111121111112112111211111111111
121112111221211111111111111111111111111111211211111111111112121111111221111112111111212111111111112211211121111111112112112111111211111121121112111111
121111211112211111111111211111111111211111111111112111111111111111111111111111111112212111111111121111211111112112112111111111111211211212112111211111
111111111111111112111111111112111111111211111111111111211111111111111111111111121111111111111111111111112111111111121111111111111111111211211111111111
111112212111111111111121111111111111111111111111112122211111111111211211121121121111111111112211211111111111121111121111111111111112111111111111121111
111111221112111111111111111111111121111111111111111211111111111111111111111112111121111111111121111111121111111111111111111111111111112111111112111211
111121111121122111211111111111111211111111111111111211111111121121111121111122111111112111111111111111111121111111111211111111111112111111121111111111
111112111111211121221111212111111112111121111211112111112111112111111111111111111211121112111111111211111121111211111112111112112211111121112111111111
111111111211111111111111111111111111121112112122111111211111111112111111121111211111111111111122111111111111111111111111111111112112112111111111121112
111211111121121111111111112111111111111111111211211211111212111111121111111111211112211111111111111111111111122111111121111211111111111111111122111111
112111211111211121111111111111112111111111111112111111111111211211111112111111112112111111112111111212111111111211111111121111111112111111112111111111
111121111111122112211221111111211112112111111111111111111111121211121111111111111111111111111111121111111111111121112121112111111111111111111211111121
111211111111111111212111111111111121121111121112111211111211111111111121121111111111111111111111111111121112111112111111111121121121111211111111111111
211112111111111111111211121111111121112211111211121112111111221111111111111211111211111111111111211121221111111111111221111211111211111111111211111111
111111111212111111211221121111122111211111111111111111111111111111111111111212111111112121111111111111211211112121111111111111111121111211111111211111
111112111111211112111111111121112111211112121111111112111111112111111121111111111111112111112112111111211121111111111111111111221112211111111111111211
121111111121111121112111111111111121111211111111121112111111111111121112121112111122211111111111111111111111111111121111111122111111111111111111111111
111111121111111111112112121121112111121111111111111221111111111111111121211211111111212112111112111111111111111111112111111111121111111111111111111112
112121211111122111111111111111122211121112111111111111112211111112111112121111111111111211111211211111212121111221111111111111221111111111112111212111
111111111111122111111111111111111111122111221112111211111111111111111111111111211111111121111111111121111111111111111112111221111111111211111111111121
111211211111111211111112111111111112111211111111111111111211211111111111111111112211111212121111211111111111211111112111121211111112122111111111111111
121112111211111211112121122211111121111111111111112111111111111112111112211212111111112121111111111111111112111111121111111111112111111121121111211111
111111111111111211112111111111111111111111111111111111111111111211112111121111111111111111111121111111211111111111111111111112111121111112112211211111
111211111111111121211111111111111111111211112111211112111111111111111111122112111111211112121111111121111111122111111111211121111111111111111121121111
111112111111112111111111111111111111111111111111121111212111122111122211112211111111111111111111112111111111211111111121111111111111111112111111111111
211111212111222111111211111121211211211111111222111111111111111122211111121111111211211122111111111211111111121111111111111111111112111121111111111111
112111212211111111111111121111112111111111111111111111111111121211111111111111111111111111111121111111111121111111111111111111111111112111111122111111
111121111221111111121111111211111111112111111121111111111111112112211111111211111111111211111111121111121111111111111211111221111211111111111111211211
111111111211111111111111121111111112121111111111112111111111111111121111111111111122111111111111111111111121111112111111111111111221111111111111111111
111211111122112111111121111121111112111111121111112111111111111121111111211211111111211122111111111212111111111111111111111111211111111112111111111111
112121211111222111111111111111111111111112121111211221111111211122111111111111111121111111111121111112211111111111111121111111111111111111112111112111
111111211221111111111121111111111121221112111111111111111121111111111111111111112111111111111111111211112111111111211111111111111111221112111111112111