000000000000000000000000000000000000000000000000000000000000000000000000000000000000000000000000000000000000000000000000000000000000000000000000000000
000000000000000000000000000000000000000000000000000000000000000000000000000000000000000000000000000000000000000000000000000000000000000000000000000000
000000000000000000000000000000000000000000000000000000000000000000000000000000000000000000000000000000000000000000000000000000000000000000000000000000
000000000000000000000000000000000000000000000000000000000000000000000000000000000000000000000000000000000000000000000000000000000000000000000000000000
000000000000000000000000000000000000000000000000000000000000000000000000000000000000000000000000000000000000000000000000000000000000000000000000000000
000000000000000000000000000000000000000000000000000000000000000000000000000000000000000000000000000000000000000000000000000000000000000000000000000000
000000000000000000000000000000000000000000000000000000000000000000000000000000000000000000000000000000000000000000000000000000000000000000000000000000
000000000000000000000000000000000000000000000000000000000000000000000000000000000000000000000000000000000000000000000000000000000000000000000000000000
000000000000000000000000000000000000000000000000000000000000000000000000000000000000000000000000000000000000000000000000000000000000000000000000000000
000000000000000000000000000000000000000000000000000000000000000000000000000000000000000000000000000000000000000000000000000000000000000000000000000000
000000000000000000000000000000000000000000000000000000000000000000000000000000000000000000000000000000000000000000000000000000000000000000000000000000
000000000000000000000000000000000000000000000000000000000000000000000000000000000000000000000000000000000000000000000000000000000000000000000000000000
000000000000000000000000000000000000000000000000000000000000000000000000000000000000000000000000000000000000000000000000000000000000000000000000000000
000000000000000000000000000000000000000000000000000000000000000000000000000000000000000000000000000000000000000000000000000000000000000000000000000000
000000000000000000000000000000000000000000000000000000000000000000000000000000000000000000000000000000000000000000000000000000000000000000000000000000
000000000000000000000000000000000000000000000000000000000000000000000000000000000000000000000000000000000000000000000000000000000000000000000000000000
000000000000000000000000000000000000000000000000000000000000000000000000000000000000000000000000000000000000000000000000000000000000000000000000000000
000000000000000000000000000000000000000000000000000000000000000000000000000000000000000000000000000000000000000000000000000000000000000000000000000000
000000000000000000000000000000000000000000000000000000000000000000000000000000000000000000000000000000000000000000000000000000000000000000000000000000
000000000000000000000000000000000000000000000000000000000000000000000000000000000000000000000000000000000000000000000000000000000000000000000000000000
000000000000000000000000000000000000000000000000000000000000000000000000000000000000000000000000000000000000000000000000000000000000000000000000000000
000000000000000000000000000000000000000000000000000000000000000000000000000000000000000000000000000000000000000000000000000000000000000000000000000000
000000000000000000000000000000000000000000000000000000000000000000000000000000000000000000000000000000000000000000000000000000000000000000000000000000
000000000000000000000000000000000000000000000000000000000000000000000000000000000000000000000000000000000000000000000000000000000000000000000000000000
000000000000000000000000000000000000000000000000000000000000000000000000000000000000000000000000000000000000000000000000000000000000000000000000000000
000000000000000000000000000000000000000000000000000000000000000000000000000000000000000000000000000000000000000000000000000000000000000000000000000000
000000000000000000000000000000000000000000000000000000000000000000000000000000000000000000000000000000000000000000000000000000000000000000000000000000
000000000000000000000000000000000000000000000000000000000000000000000000000000000000000000000000000000000000000000000000000000000000000000000000000000
000000000000000000000000000000000000000000000000000000000000000000000000000000000000000000000000000000000000000000000000000000000000000000000000000000
000000000000000000000000000000000000000000000000000000000000000000000000000000000000000000000000000000000000000000000000000000000000000000000000000000
000000000000000000000000000000000000000000000000000000000000000000000000000900000000000000000000000000000000000000000000000000000000000000000000000000
000000000000000000000000000000000000000000000000000000000000000000000000000000000000000000000000000000000000000000000000000000000000000000000000000000
000000000000000000000000000000000000000000000000000000000000000000000000000000000000000000000000000000000000000000000000000000000000000000000000000000
000000000000000000000000000000000000000000000000000000000000000000000000000000000000000000000000000000000000000000000000000000000000000000000000000000
000000000000000000000000000000000000000000000000000000000000000000000000000000000000000000000000000000000000000000000000000000000000000000000000000000
000000000000000000000000000000000000000000000000000000000000000000000000000000000000000000000000000000000000000000000000000000000000000000000000000000
000000000000000000000000000000000000000000000000000000000000000000000000000000000000000000000000000000000000000000000000000000000000000000000000000000
000000000000000000000000000000000000000000000000000000000000000000000000000000000000000000000000000000000000000000000000000000000000000000000000000000
000000000000000000000000000000000000000000000000000000000000000000000000000000000000000000000000000000000000000000000000000000000000000000000000000000
000000000000000000000000000000000000000000000000000000000000000000000000000000000000000000000000000000000000000000000000000000000000000000000000000000
000000000000000000000000000000000000000000000000000000000000000000000000000000000000000000000000000000000000000000000000000000000000000000000000000000
000000000000000000000000000000000000000000000000000000000000000000000000000000000000000000000000000000000000000000000000000000000000000000000000000000
000000000000000000000000000000000000000000000000000000000000000000000000000000000000000000000000000000000000000000000000000000000000000000000000000000
030000000000000000000000000000000000000000000000000000000000000000000000000000000000000000000000000000000000000000000000000000000000000000000000000000
010000000000000000000000000000000000000000000000000000000000000000000000000000000000000000000000000000000000000000000000000000000000000000000000000000
310003300000000000000000000000000000000000000000000000000000000000000000000000000000000000000000000000000000000000000000000000000000000000000000000000
113031100000000000000000000000000000000000000000000000000000000000000000000000000000000000000000000000000000000000000000000000000000000000000000000000
111311100000000000000000000000000000000000000000000000000000000000000000000000000000000000000000000000000000000000000000000000000000000000000000000000
111111133000000000000000000000000000000000000000000000000000000000000000000000000000000000000000000000000000000000000000000000000000000000000000000000
111111111000000000000000000000000000000000000000000000000000000000000000000000000000000000000000000000000000000000000000000000000000000000000000000000
111111111300000000000000000000000000000000000000000000000000000000000000000000000000000000000000000000000000000000000000000000000000000000000000000000
111111111100000000000000000000000000000000000000000000000000000000000000000000000000000000000000000000000000000000000000000000000000000000000000000000
111111111100000000000000000000000000000000000000000000000000000000000000000000000000000000000000000000000000000000000000000000000000000000000000000000
111111111130000000000000000000000000000000000000000000000000000000000030300000000000000000000000000000000000000000000000000000000000000000000000000000
111111111113000000000000000000000000000000000000000000000000000000000310100000000000000000000000000000000000000000000000000000000000000000000000000000
111111111111000000000000000000000000000000000000000000000000000000000113130000000000000000000000000000000000000000000000000000000000000000000000000000
111111111111030000000000300000000000000300000000000000000000000000003111110000000000000000000000000000000300000000000000000000000000000000000000000000
111111111111313000000000130000000000000100000000003000030300000000001111113000000303003300000000000030003100000000000003000300000000000000000000000000
111111111111111033303033113300000030033100000000001300013100300000331111111000033131031100000000000310001130000030003031000100000300000000000000000303
111111111111111011131011111103030010011130000000031130311100100000111111111033311111311130000000000110031110000010031011003133000100300300300030030101
111111111111111311111311111131313313311113333333311113111133133333111111111311111111111113333333333113311113333313311311331111333133133133133313313131
111111212111112121111111212212112111111112111111111111111111111121111111111111111121111122111111111211111211111111111121111111112212212111112111111111
111121111111112111111111111211111111111212111211111121111111111111111111111211111211221111111111111111121111211211111111112111111121111111111111111111
121211111111111111111111111111111111111111111111111111121111211111111121121111111122112121111111111111111111111111111111111111111111111111111111111111
111221121111211111121111121111111111112211211111121111111111111111122121111111211111111212111111211111111111112111211211111111112111111111111111111111
111111111112121211111111111111111111211211111111111111111111111112111112112111121111112111112111121121112111111111111111211112112111211111111111111111
111212121111222111111111111112111111111121111111112111111121111111111112112111111121212111111111111111112111111121111111111222111122111112112112111121
111111221111111112111112111111111111111221111111111112111111111111211111211112111111112211111112111111211121121112111111111121111111112111111111211111
111111111121111111111111111111111111111111211112111112111111112111221121111111111111121111111111111112111111111111112111111211121111112211211211111121
111211122111111111111111111111111111111111111111111111112111212111211121111111111111111111211211111111122111111111111111211111111111111211111111111111
121111121111222112121112111111111111112121111111111112112211111111212111121111111111111111111112111111211111211111121111111111112111111111111111111111
121111211111111111111111112211112111111111111211121111111111211211211112211111111111111221111212221112112212111111112112121111111121121111211111111111
211121121111111121211121111111111111111111111111112121211111211111111111211112111111111111222121111111111111111111111221111112111111111111112111212111
111111111111111111111111111111111111212111112111111111111111111122111111111111212111111111111211211111121111211111111111121111111111112211211211111111
111112111111111111211111111111111111111111111111111111121111112111111111111111111112121211111111111111111111111111111211111112122111112211111211111111
112111211111112112121111111111111121111112121111112111112211121111111111111111111111121112111111111111111111111112111111121111111211211121112121112111
111112112111112211112111111111111121111111111211111111112211112111111211111111111112111111111111112121211111111211111111112221121121111211111112111111
111111111121112112111111111212111111111111111111111111111111111111121111211121111121111111111111111122111112121111111111111111111121121121211111211121
112211111111111112111111211111112111111111111211111112112112111111111221111111111111111111211111121111111111121111111211111111111121111111111111111221
111111111112111111111112211111112111111111111111211111111211121111122111111111111211111111111111111111111112111111111121111111111111111111111112111211
111111121111211111111111111111111111121111111111111111111121111211112111111111111111112111111212121111111111111111121211121111111111111111111211211112
111121111111111111111221121112111111112212112111111111111121111122111211111111112112111111111111111121111111111111211111121111111112111111111111111121
111121211111111111212112111112211211112121112111111111111211111111121122111111121111111111211111211111111121111111111111211111111111212211111111111111
111111111112111111111121111121211112111112111211121111111111111211111111111121111211111111111111111111121111111111111111111111111122111122121111111112
111111111111111111111112111111111111221111211112111211121121111111112111111211111111111111111111112111111211121111221211111111111111121121111111111111
211111111121111111111111111111111111212111212111111111211111111111121111111211111111111111121112111111111211112111111111121111111111111112111111111211
111111111121111111111112111111111111111121111111111111211112212111111111112111111111111111111111111211111111211111111111111121111111121111111111111112
112111111112121111111121111111211111112111111111111112111111111111111111111111111121111111111111111211111111121111111111111111112111111121111111111112
111111111111111111121111111111111121121121111111111211111111111111111111111111211112122111111211111211111111111111121211212211111111221111111111111121
211211111111111111111121111111111111111112111112122111111111111111111111111111111111111212111111121121111111211111211112111111112212122112111111111112
111111112111111111111111111122211111111111112111211111111111112111111112112211211111112221112211111111111111111111111111111121211121211111211111111111
121111111211211111111111111111111211111111111111111111221111122111111112111111111112112121111121111111112121111121211111111212121111111111111111121122
111212111211111111121121111121111111211211111111111111111121111111111121111111111211111112211111111111111112111111121111111112111211111111111111111111
111111111111112111112111111211111111111111111111211111111111111211111111211111111112111111121112111211212111211111111111111112111111111121111111121111
112211111211111111111111121111111111111221111211121111111222112112111111122111111111111121111111111111111111111112111111111112221211111111121111111111
111212211111211112111112111111112111211111111122122121111111111112111111111111111111111112121121112111111111111112111111111111111212111111211111111111
111111112111121111112111111111112112221111111111121111111111111211211111121111111111111111111112211111111111211112121112211111111111112111211111111111
111111111111111111121111111111111112112111111111121111112111111111112111111111111111111111212111122111111111111111211221111111121111111111111211111111
111111111111111111112121111111111111111211111111121111112211211111111111111111111111111121121211121111111111111111111211212112111111121121212111111111
111121111111111111121211121111111121121111111121111111112111112111111111111111111111112111112112111111211111111121111122111111111111111211111111111111
111111111111121111112211212111111121111211111111111211211111111111111111111111111111221111211111211111111111111111111111211111112111111111221111121121
121211111212111111112111111111112111111111111111111111121111111111111111111111212211211111211111111121111111111111111111112111111211111111111111111111
111111211111111111211111211111111112111111112121111111111111111121111111111111121111111111111111111111211111111111121112111111111111111111111111111111
112112121111111111211111111111122211111111111121111121111111111112111112111211111111111111122121111111111111111111111111111111211121111111211122111111
111111121111111111111112212111111111112111111111111111112121112111111111111121211111111111111111112111111211111112112211111111211212212111111121112121
111111111111111112112111211111111111111111122111111211111111121111111111111111111111111111111111111111111111121111211111111111121121112111211111111121
111111212211111111111111111111111111111211111121111111111111111111111111111111111111111221111112111111111111111211111111111111111111211111121111111111
111211111111111212111121111111121112111111121112111111121211221111111111111111112111111111211111112211211211111111111111111111111121111111211112111111
221121111111221112112212112111111121211111121211111111121211111111212112112211111111111111111111111111111111121211112111111111111121111121211111111111
211121111121111111111111111211111111121111111211111111111112111111211211111111111111111111111111111111112211121111111111111111121111111111211111111111
111211221112111111111111111111111111121111111111111111112111111111111121111111111111111121111111111112121111112111111221111111111111111111111121111111
111111112112112111112112111111112111211111111112112111111112221111211111211111111111211111112212121111111121111111111121211111122111111211111121111111
111211111111111111111121111111111211111112211111211111121111111111112111211112111111111111111211111111111112211112111121121121111111111111111211111112
111111111121211211111111111211121111111111122111111111112111111111112111111111111111121111111111111111111111111111212111121212111111111211111211121111
111111111111111211111111111111111111112111111112111111221111111112111112111111211111111111112111111111211111111211121111111121111111112111111111121111
111111111111121211111211111111112111111111111111111211111111111111111111111111111111111111111111121211111112111111121111112111111111111111111221111221
111111112111221111111111111111111112111111111211112221111111111111111211121111221111122111211121111111111111122111111111122111211111211111112111121122
211111111111111111211111211111121111121111121111112212111211111121111111221111111112111221122111211111111111111111121121111111111111212221121111111111
111111121111111112111111111111112111111111111112111111121111111111221121111111111111111111111121111111111111121111111111111112111111111111112112111211
111112211121121111111211111111211111111212211121111111121111111111121111112111111111111111121122111121111111211111111111111111111111121121111111111112
111111211121111111211111112111211111111111111111112111111111211111111111121212111211111111112111111111111111111111111211112111122111111121111121121112
121111112111111111111111211121111111111111111111111111111112111111111111121112111111111111121111111111111111111111211111121111111111111111211111111121
111111112111111112112112111111112111111121111111111111111111111111212111111211111111111111211111111121112111111121111111111211111121111111111211121111
111111111111111111111111121111111211111111121211121111121111111111111111111111111211211211111211121112111111212111111221211111111111121112112111111111
111111122212111111111112121121211111111111111111111112111111111111111111111111121111122112111111111111111112211111211111111111211212111111111121111111
111121211111111111122111112111111111111111121112111111111112111112112111211111111111111112211111111111111111111111112111111111211111111111111111211111
111111111112121111122111121112111111121121111111112111111111111211121111111111111111121121111111111111111111211121212121111111111111111111111111111111
112111111121111112211111111111111121111111121211111112211111111111121111111121111211211111111121211111111111112111111111211121111111111111111111111111
211111221211121111111111121111111121111111111111111111111111111121111111211111111111111111112111111112111212111212111221111121111121211111211111111111
111111211111111111111111211111112121211112221111121211111111111111111111111121111111111111122122111111111111111112211111121221111111111111111111112211
111111111111111111112111111111121211111112121111111111221112211121111111111111111211111111121211121111111121111111122111111111112121111212111111111111
121111121111111121111112221111112111111111111111211111111111111111111121112111112121121211111111111212112212112211111111111112111111111111211111121111
112111211111221111111111111211121221111111111111111111111221211212111111211121111111111111121111111111111111112111111111111212111111111111111121111111
111111211111111111121111111112111121111111121111111111111111111111111111111111112111121111111112212221112111211111111211211111112111111111111111111111
111111121111111111111112121111112111121112111211111221111121111111111111111121211111121212211111111112112111112111111111111111112111111111111111121121
111111111111111211112121121111211121111111111121111111111111111121111211111111111111111111111112121211111111111112121112111111111111111111111111211111
111111111121111112211111111111111111111111111111121111111111121111111112112111111111111121111211111111211111121222111211112112121111111111111211111111
211111111212111211211111111111111111111111111211111111111111111212111211211111211111111111211111111111211111111111112111111111111111111112111111111121
111111111111121111211111111111211211111111111111111111111111222111211111211121112111111111111111111111111121111121111112111111111111111111211111111111
112121111111111111111111111121121111111112112111121121122111111111111111111111111111121121211211111111112111111212111211111211111111111111221111111111
112111111111111111111111111111111112111121211121111111111111111211112111111212111112121111121111111111112111112111112111211111211111211111111111121111
112111121111111121111111111222211211111112112111121211111112111111111111111111111221111111111111121111111121111111111112111121111111111121211111111121
111121111111111111121112111111111111111111211111111111111111111112111111121211111111111111111111112111211111111111111111121111112121121111111112111111
211111111111111111111111121111111111112121221111111111111221112111111111121121111121121121111211111111111111111111111212111121111221111112111111111111
111111121111111111211111211211111111111121111111111111111121122211111111111211111111112111111111211111111111121111112111111111111121122111111111111111
111121111211211111112111111121111111111112111121121211111111111111111112111111111111112111111111111111111111111111121111111111111211111111111111112111
111111111111111121111111111111111111111121211111211112111112111111111112111111111112111111111111111111111111111111111111211121111111212111111211111111
111111111111111111111111111111112111111121111111111211111111111111111121111111111111111112121111121111111211121121122111111211111111121111112111111111
111112111111111121121212121211211211111111111112111111111111111111111211111111121112111111111111112111111111121111111111112121111121121112111111111212
121111111111111211111111211122111211211111111111111111211111111111121121111111111121111111111111111111211121111121211221111111111111111121111111111111