000000000000000000000000000000000000000000000000000000000000000000000000000000000000000000000000000000000000000000000000000000000000000000000000000000
000000000000000000000000000000000000000000000000000000000000000000000000000000000000000000000000000000000000000000000000000000000000000000000000000000
000000000000000000000000000000000000000000000000000000000000000000000000000000000000000000000000000000000000000000000000000000000000000000000000000000
000000000000000000000000000000000000000000000000000000000000000000000000000000000000000000000000000000000000000000000000000000000000000000000000000000
000000000000000000000000000000000000000000000000000000000000000000000000000000000000000000000000000000000000000000000000000000000000000000000000000000
000000000000000000000000000000000000000000000000000000000000000000000000000000000000000000000000000000000000000000000000000000000000000000000000000000
000000000000000000000000000000000000000000000000000000000000000000000000000000000000000000000000000000000000000000000000000000000000000000000000000000
000000000000000000000000000000000000000000000000000000000000000000000000000000000000000000000000000000000000000000000000000000000000000000000000000000
000000000000000000000000000000000000000000000000000000000000000000000000000000000000000000000000000000000000000000000000000000000000000000000000000000
000000000000000000000000000000000000000000000000000000000000000000000000000000000000000000000000000000000000000000000000000000000000000000000000000000
000000000000000000000000000000000000000000000000000000000000000000000000000000000000000000000000000000000000000000000000000000000000000000000000000000
000000000000000000000000000000000000000000000000000000000000000000000000000000000000000000000000000000000000000000000000000000000000000000000000000000
000000000000000000000000000000000000000000000000000000000000000000000000000000000000000000000000000000000000000000000000000000000000000000000000000000
000000000000000000000000000000000000000000000000000000000000000000000000000000000000000000000000000000000000000000000000000000000000000000000000000000
000000000000000000000000000000000000000000000000000000000000000000000000000000000000000000000000000000000000000000000000000000000000000000000000000000
000000000000000000000000000000000000000000000000000000000000000000000000000000000000000000000000000000000000000000000000000000000000000000000000000000
000000000000000000000000000000000000000000000000000000000000000000000000000000000000000000000000000000000000000000000000000000000000000000000000000000
000000000000000000000000000000000000000000000000000000000000000000000000000000000000000000000000000000000000000000000000000000000000000000000000000000
000000000000000000000000000000000000000000000000000000000000000000000000000000000000000000000000000000000000000000000000000000000000000000000000000000
000000000000000000000000000000000000000000000000000000000000000000000000000000000000000000000000000000000000000000000000000000000000000000000000000000
000000000000000000000000000000000000000000000000000000000000000000000000000000000000000000000000000000000000000000000000000000000000000000000000000000
000000000000000000000000000000000000000000000000000000000000000000000000000000000000000000000000000000000000000000000000000000000000000000000000000000
000000000000000000000000000000000000000000000000000000000000000000000000000000000000000000000000000000000000000000000000000000000000000000000000000000
000000000000000000000000000000000000000000000000000000000000000000000000000000000000000000000000000000000000000000000000000000000000000000000000000000
000000000000000000000000000000000000000000000000000000000000000000000000000000000000000000000000000000000000000000000000000000000000000000000000000000
000000000000000000000000000000000000000000000000000000000000000000000000000000000000000000000000000000000000000000000000000000000000000000000000000000
000000000000000000000000000000000000000000000000000000000000000000000000000000000000000000000000000000000000000000000000000000000000000000000000000000
000000000000000000000000000000000000000000000000000000000000000000000000000000000000000000000000000000000000000000000000000000000000000000000000000000
000000000000000000000000000000000000000000000000000000000000000000000000000000000000000000000000000000000000000000000000000000000000000000000000000000
000000000000000000000000000000000000000000000000000000000000000000000000000000000000000000000000000000000000000000000000000000000000000000000000000000
000000000000000000000000000000000000000000000000000000000000000000000000000900000000000000000000000000000000000000000000000000000000000000000000000000
000000000000000000000000000000000000000000000000000000000000000000000000000000000000000000000000000000000000000000000000000000000000000000000000000000
000000000000000000000000000000000000000000000000000000000000000000000000000000000000000000000000000000000000000000000000000000000000000000000000000000
000000000000000000000000000000000000000000000000010000000000000000000000000000000000000000000000000000000000000000000000000000000000000000000000000000
000000000000000000000000000000000000000000000000000000000000000000000000000000000000000000000000000000000000000000000000000000000000000000000000000000
000000000000000000000000000000000000000000000000000000000000000000000000000000000000000000000000000000000000000000000000000000000000000000000000000000
000000000000000000000000000000000000000000000000000000000000000000000000000000000000000000000000000000000000000000000000000000000000000000000000000000
000000000000000000000000000000000000000000000000000000000000000000000000000000000000000000000000000000000000000000000000000000000000000000000000000000
000000000000000000003000000000000000000000000000000000000000000000000000000000000000000000000000000000000000000000000000000000000000000000000000000000
000000000000000000001000000000000000000000000000000000000000000000000000000000000000000000000000000000000000000000000000000000000000000000000000000000
000000000000000000031000000000000000000000000000000000000000000000000000000000000000000000000000000000000000000000000000000000000000000000000000000000
000000000000000003011300000000000000000000000000000000000000000000000000000000000000000000000000000000000000000000000000000000000000000000000000000000
000000000000000031311230000000000000000000000000000000000000000000000000000000000000000000000000000000000000000000000000000000000000000000000000000000
030000000000000011111110000000000000000000000000000000000000000000000000000000000000000000000000000000000000000000000000000000000000000000000000000000
010000000000000311111110000000000000000000000000000000000000000000000000000000000000000000000000000000000000000000000000000000000000000000000000000000
313000000000033112111113000000000000400400000000000000000000000000000000000000000000000000000000000000000000000000000000000000000000000000000000000000
111300330300012111112111000000000000240240044000000000000000000000000000000000000000000000000000000000000000000000000000000000000000000000000000000000
111130110130311111112211000300000002444440044000000000000000000000000000000000000000000000000000000000000000000000000000000000000000000000000000000000
111113113110111111112111300200000444444224422000000300000000000000000000000000000000000000000000300000000000000000000000000000000000000000000000000000
112111111113111111111111103130000444444424444300033100000000000000000000000000000000000000000000100000000000000000000000000000000000000000000000000000
111112112111111111111111101110344444444444442230311100300000000000000000000000000000000000003003130303000000000000000000000000000000000000000000000000
111112211111111111111111131113244444444244422110111230200000000000000000000000000000000000031001110231000000000000000000000000000000000000000000000000
121111111112111111212111111111444444444444444413111113230000000000000000000000000000000000012332113121000000000000000000000000000000000000000000000000
111111112211111112122111121121444444224444444111211111110000000000000000000000000000000000311111211111300000000000000000000000000000000000000000000000
221121112111221122211112212111444444444442444112111211110000000000000000000000000000000000111111111111130000000000000000000000000000000000000000000000
111211211111111111111111112111444444444444444111121111113000000000000000000000000000000003111111111111110000000000000000000000000000000000000300000000
211112112111111211121111111111144424442444442411111111111300000000000000000030000000000001111111111111113000000000000000000000000000000000000100000000
111111111121111111111121111111144244444242444411121111111100000000000000000010300000000332211112112112111070000000070000000000000000000000003100000000
111111111211111211111211111111144444444444444411111121112130000000000030003310230030000111111121111111111060000000760000000000000000000030001130300000
111112111111211121221111111111422444444444444211211121111110000300000013001113120010303111111211121121121367007007667700000000300033033310031110130000
111112211111111111111122121111124444444444444411112111111113333133333311331111113313131111111111111111111266776776666677333333133311311213312113113333
111111111111112121111111211112144444244444444411112112111111212111112111111111111111111112111112111111111162666666266666212111211112112121111211111111
111111211111111211111112111111144422444424444111111112111111111111111112111111121111211111111111111111111166666666622622611111111111112111111111211111
111121211121112112111111111121144444444444444212111112112111211111111112112111121111111111112111211111111666666666662666111112111122211111111111121111
111111111111112121121111111112144444444244444411111111111111121111111111111211111111111111112211111111111666666262666666211111111111111111112111111122
111111111111111111111111211111144444444444244111211121211111121122112111111121111111121121121111121121111166626266666666111121111111121111111111111211
111112111222121111121111111112144444444244442411211211111111111111111111111112111111111122111111121111111666666666266226121211111112111111111121111111
111111211111111111111121111111144444444444444411111111121111122111122111111211111111111111121111111111111166622266662666111111111111111112111111111112
111121111121112111111211111111444444424244444111111111111111111111211221111112111111111111111111211112111166626626666666611112112121111121111121111111
111111211121121111111111111111444424244444444121111221211121111121111111111111111111111111111112121211121262666666266666111112211112111111122111211112
111111111111111122211121111111142244444242444411211111111111112111121111111211111211111111211121111111111266626626666666121111121111111121211111122111
111111111111111111111111111112444444444442444411112111111111211111111111212112111112111211111111111111121166666666262662111111112111111211112121111111
211211212111111111111211122111242444424444444211111111111112111111111111111111211111111111121111121121212266666666266666111121111121111111121121111111
112121111111111211111111111111444444444442424411111211111112111111112111112111111111111111111211111122112666666666666666111111111111111111121111111111
111112121112111111111111111211224444444444444411221111121111111111121112111111111111111111111211111211111166666666626666611111111121121111111111111111
111112112111112111222111111112144444424444442412212111112111111111122111111111221112111111111111111111111166666662262626611111111111212211111121211112
111111111111111211211211111111244442444444444411111111111111111211111111111211111111111111111112111111111166666626662666211111111111111211111111112111
111111111111111111121211111111424244444422442412211111111211221111211212111211111111111111111111111112111126666666666266111111122111111112111111111112
111111112111111111111111111112142444444424244412111111111121111111111111112111111111111111211111111111211162666266666666111112111111111111111111121122
211111211111212211211111111121244444442424244422111111112111111221111111112112112111111211211211111111111666666666666666621111112111111111111111111212
111211211111111111111111112111144424444444444112111111111111111111121111121111111111112111111112211211211626666666666266122111211112111111111111111111
111111111121111211212111111112144444444444444411111111111111121211211111111111121111111212111121111111111126266666626662111211121111112111111111111111
111111111111112111121111111111244442244444444411111111111111111211212211121111111111111112111111211111111162666666666666621111112211211111211211111111
111112111111111111112111111111144442444444442411111111121111111111111111112111111111111111221111111111112262626622666666121111111111111111212121122111
111111112111111111111111111122144424444424244111121111111211111112111111111111111111111111111111111112111666626666666666111111112111111111121211112121
111111121121121211111111112111244424444244444411111111221111111112111111111221111112111111111121111212111666666662666666112111111111212111111111111111
111111111121111211111111111111144444444444444411112111111111112111111111111211111111111211111211111111121666666666666666611121121111111111111121111121
121112111112111211122111112211444444244444444411211111111112211111111121111111111111111112111111121121111266662666666666111111111111111211111111111211
111111111111211111111121111111142444442444244111121111111121111111111111111111121111112111111111121122111126666666666666111111111121111111111211111111
122111111111111112111211121111424444442444444411111111121111111111211121211111111111111111112121111111111666626666666626111112111111211111111112121111
111111111111111111111111121121144424444444442111111212111211111111112111212111112111111112111111112111211666666666666666611111121121111111111111111111
111211111111112111111111111122244424244424444111111111112111112111111111212111111111111212111211211111111162666666666666211111111111111111111111111111
111211111111112111111111111111244444442444444411111111121111111111211111111122111111111111112111111111111666266666666666111221122111111111221211212111
111111111111121111111111111121444444444442444421112111111121112111111111121111111111211111111111111111111166266662666666611111111111111111111111111111
211211121112111111111121111111444444444444444111111111211111111112111111111111111111111111122111112111112162666666666626611111111211111122211112121111
211211111111111111212212111111444444444442244412121111111111111111111211121111111111111111121111111221111666226666666666121112111121111111111111221121
111122111111111111211111112111444444244424444411111111111121211111111111111111121121111121112111111121111666666666666666611121111211111111211111221111
111111111111112111121111111211442444442442244411111111121111111111111111111111111121111111111112111111111162666626666666611111111111111111111111111112
111121111111112111112121111111144422444444442211112111211111111112111111111111211111111111111111111121111166262666666266111111211111111121112111111111
111221121111111111111111211121444444444424444411111211112111111111111111111111111111111211121111111111111666666666666626611221211111122111121111111111
111111112211111111111211111111144244444244444411111111111111111111111111111121111112111111111111111111111166666662666666621111111111111111111111111121
121112111111111112112111121111444444444424444111112112111111211111211221111111221211111111111111112111112126666666666626122111111122121121111111211211
111212111111111111212111121112444442444244442411111112111111111111111111121112211111111111111111112111111166666666666666111111111111111111111111111111
121111112111121211111211122111444444444244444411111111121111211111111111111111111122111111111111111111111666266666662666611111112111111211211111111111
111111111211111211111111111111144444444444424112112111111111111111211111111121211111111111112111112111111166666666662662111111121211122112111111111111
121121111111111111111111211112144444444424422111112111121121111111111111111212112121111111111111111111122662666226666666111111112111212111111121111121
121121111111111221112111111121444444442422444111121111111111111211111121111112111112111111212121111111211166666266666666611111121111112121121111111112
111111111222111111111111111111444244444422444412111111121111111122111111121111111111111111111111111111211166666666266666211112111111211111121211111112
111111111111221111111111111111144444444444444121111111111221111111111112111111111111111112111111111121111166666666266666611111111121221111211121111121
111111111111121111211111211121444444244442444211111111111111121112111111111111112111111111111111121111112126666666666666611112111221111211121111111111
111121112111111111111212121111244244424424444112111111111111111121111111111111111111111111111111121111111166666666666662611121122111211112111111121111
111211111111111111111121211111244444244424244121111111111111111111111112111121211111111112111111111112211666666666662666112112111111121111111111111111
111111112112111111211111111121444444444444244412111111211212111112112111111111211111211112121111111111112666666666266666611111111211111111111111111111
111112111111111111111111111111444424424444444111111111111111121111111112212111211112111111111121121112111662666666666666611111111112111111111111121111
111111111111211121111111211111444444442444442211112112112112121111111111211111111111111111111111111211122666666666666226611111121111111111111111121111
111111111122111111121111112111142444424444444111111111211112111111111211111111111111111111111111121121111166666662666666221111111111112211111111111112
211111111121211111211211111111444444444444444111111111111111212121112221121111111111111111211111111111111666666266666666112111111111111111121111111111
111211112111111111111111121111124244442424242111112121112211111111111111111111111111111111111112111112111666666266266266122121111121111112111111111211
221121111111121111111111221211144444442444424111111112111111121112111111211111112122111121111111111121122166666666666666611111221111111111111111111121
111211111111111211111211111212444424444444424121111221111111121112112111112211121111111111112111211112111666626662666666111211111121111111111121111111
111111111111111111111112121111442422444444424211111111111111111211111111211211111111111121111111111111121666666666666626611111112111211111111112111111
211111112111112121112111111111144444442444444111111111111111111111122111111122211211122112211122111211222666666626626266111111111211121122111121112111
112111111111111111111111111111444442444442444411111211111121111111111111111211111111121111112111111111111266662666666666112221112112111211111111111111
111111111111111211111212111211244444444424444112111111111121111211211111111111121112111111111111111111112666666666666266111111121121111111111111111112
111121111121111111112112111111444444444224444411111121111111121111121211111111211111111211112111121122111162666626666662611111111112211111111111111121
111111111111111111111111111111242224444244444422111111121211111112112111111121111111111121111112111111111666666666666626211111111111112111111111111221
121111111111111111111111211111144444244444444421111111111111111111111111122111111111111111111111111111111266666666626666111112111111111122111121111111
121111111111111111211111111111444444444444444111111111111211121212212111121212211111211111111111111121121166626666666666111111111111211111111111111121
111111121111111111112111111111144444444444442421111111111121211111111111111111111111112111111111111111111666666666666666612111111111111111112121121111
112111121111121111111111111111144444444444444411212112111111111121112111111111111121111111122111111121111166266666226222611111111111111111111121211111
111112112112111112111111111111222444444444444211211111111211111111111212111111211111111111111111112111111162666666266662611121111111111112111111111212
212112111121111111111211111121144444442244444211111111112121111111111111111111111111211112121221111121111262266266622666611111111111111111122111111111
111111111111111112111112121112244444424224422411211112121211111121121111111211111111122111211211111111121662666662666666611111112112111111111111111122
112111211111121111111112112112244242244442444411111111211111112111111111112222121211111211111111211112111162666666666266211111211111111111111221111111
112111112111111111111111111111144442444444444411111111222211111111211121111111111111111111111122111111211166666666666266111111111111112111121111111111
111111111111111211111111111112444444444444444111111111111111122111111111111111121111111112111111211111111622666266666666612111111111111111112121111111
121111211111112111211111111111142442444444422411111111111111111121112111111112121111111111111121111111111666666662626662612211111211211121111111112111
111111111111111111111121121111444444442444444111111111111211111111111212121111111111111111112211112111111666666666626266111121212211211111111122112111
111121111111111111112211121211144424242244444111111212111121111111111111111211111111211111121111111211211166666666666666611112112111111111121111111121
111111111111121111111111111111124244444444444211211111111111112112111111211112111111111112122111121111111266662666666666211111111111112111211112111121
111122211211112111111211111111144444444444424111111111121111111111111112112121111111111111122111111111111666622666666622111111111111111111111111221111
111111111111211111112111111112144444442444444121111111111111112211112111111111111111111111111111211111121666666666666266111211111111221112111111111111
111111111111111111111212112111422444444444424111212111121111111122212111111222211111112111111111111111211166666666266666112212111112121111111111111111
111111112212112111222111111211144444424444424411111111111111111111111111111111111111111111121111111112111666666666222666111111111111211111111111121112
111111121111111111111211111112244424444444444111111111112111111112111121211112211111221212211111111111111166666266266662111111111112111111112111121111
111111111121112111111211111111444444444244444211111111111111211111112112112111111111111222112111111111111166626666666662611121111112111111121111111211
111111111111111111111111111121142444444442424111111112111111111211111211112111121111112112111111111211111662666666666266611111111121111111212111111111
122211211211111111121112111111444444444444444121112112111121112111111111211111111111121112211111111111112166666626666266611112121111111112111211111121
121211111111111112111111122111144444424442444211111111111111111212111111211121111111111111111121111111111166666666666666611211111112111111111111211111
111111111211111112111211111111144442444442444411211211111111111111121111211111211121111111122111111121111126266666666666611111111221211121111111111111