000000000000000000000000000000000000000000000000000000000000000000000000000000000000000000000000000000000000000000000000000000000000000000000000000000
000000000000000000000000000000000000000000000000000000000000000000000000000000000000000000000000000000000000000000000000000000000000000000000000000000
000000000000000000000000000000000000000000000000000000000000000000000000000000000000000000000000000000000000000000000000000000000000000000000000000000
000000000000000000000000000000000000000000000000000000000000000000000000000000000000000000000000000000000000000000000000000000000000000000000000000000
000000000000000000000000000000000000000000000000000000000000000000000000000000000000000000000000000000000000000000000000000000000000000000000000000000
000000000000000000000000000000000000000000000000000000000000000000000000000000000000000000000000000000000000000000000000000000000000000000000000000000
000000000000000000000000000000000000000000000000000000000000000000000000000000000000000000000000000000000000000000000000000000000000000000000000000000
000000000000000000000000000000000000000000000000000000000000000000000000000000000000000000000000000000000000000000000000000000000000000000000000000000
000000000000000000000000000000000000000000000000000000000000000000000000000000000000000000000000000000000000000000000000000000000000000000000000000000
000000000000000000000000000000000000000000000000000000000000000000000000000000000000000000000000000000000000000000000000000000000000000000000000000000
000000000000000000000000000000000000000000000000000000000000000000000000000000000000000000000000000000000000000000000000000000000000000000000000000000
000000000000000000000000000000000000000000000000000000000000000000000000000000000000000000000000000000000000000000000000000000000000000000000000000000
000000000000000000000000000000000000000000000000000000000000000000000000000000000000000000000000000000000000000000000000000000000000000000000000000000
000000000000000000000000000000000000000000000000000000000000000000000000000000000000000000000000000000000000000000000000000000000000000000000000000000
000000000000000000000000000000000000000000000000000000000000000000000000000000000000000000000000000000000000000000000000000000000000000000000000000000
000000000000000000000000000000000000000000000000000000000000000000000000000000000000000000000000000000000000000000000000000000000000000000000000000000
000000000000000000000000000000000000000000000000000000000000000000000000000000000000000000000000000000000000000000000000000000000000000000000000000000
000000000000000000000000000000000000000000000000000000000000000000000000000000000000000000000000000000000000000000000000000000000000000000000000000000
000000000000000000000000000000000000000000000000000000000000000000000000000000000000000000000000000000000000000000000000000000000000000000000000000000
000000000000000000000000000000000000000000000000000000000000000000000000000000000000000000000000000000000000000000000000000000000000000000000000000000
000000000000000000000000000000000000000000000000000000000000000000000000000000000000000000000000000000000000000000000000000000000000000000000000000000
000000000000000000000000000000000000000000000000000000000000000000000000000000000000000000000000000000000000000000000000000000000000000000000000000000
000000000000000000000000000000000000000000000000000000000000000000000000000000000000000000000000000000000000000000000000000000000000000000000000000000
000000000000000000000000000000000000000000000000000000000000000000000000000000000000000000000000000000000000000000000000000000000000000000000000000000
000000000000000000000000000000000000000000000000000000000000000000000000000000000000000000000000000000000000000000000000000000000000000000000000000000
000000000000000000000000000000000000000000000000000000000000000000000000000000000000000000000000000000000000000000000000000000000000000000000000000000
000000000000000000000000000000000000000000000000000000000000000000000000000000000000000000000000000000000000000000000000000000000000000000000000000000
000000000000000000000000000000000000000000000000000000000000000000000000000000000000000000000000000000000000000000000000000000000000000000000000000000
000000000000000000000000000000000000000000000000000000000000000000000000000000000000000000000000000000000000000000000000000000000000000000000000000000
000000000000000000000000000000000000000000000000000000000000000000000000000000000000000000000000000000000000000000000000000000000000000000000000000000
000000000000000000000000000000000000000000000000000000000000000000000000000900000000000000000000000000000000000000000000000000000000000000000000000000
000000000000000000000000000000000000000000000000000000000000000000000000000000000000000000000000000000000000000000000000000000000000000000000000000000
000000000000000000000000000000000000000000000000000000000000000000000000000000000000000000000000000000000000000000000000000000000000000000000000000000
000000000000000000000000000000000000000000000000000000000000000000000000000000000000000000000000000000000000000000000000000000000000000000000000000000
000000000000000000000000000000000000000000000000000000000000000000000000000000000000000000000000000000000000000000000000000000000000000000000000000000
000000000000000000000000000000000000000000000000000000000000000000000000000000000000000000000000000000000000000000000000000000000000000000000000000000
000000000000000000000000000000000000000000000000000000000000000000000000000000000000000000000000000000000000000000000000000000000000000000000000000000
000000000000000000000000000000000000000000000000000000000000000000000000000000000000000000000000000000000000000000000000000000000000000000000000000000
000000000000000000000000000000000000000000000000000000000000000000000000000000000000000000000000000000000000000000000000000000000000000000000000000000
000000000000000000000000000000000000000000000000000000000000000000000000000000000000000000000000000000000000000000000000000000000000000000000000000000
000000000000000000000000000000000000000000000000000000000000000000000000000000000000000000000000000000000000000000000000000000000000000000000000000000
000000000000000000000000000000000000000000000000000000000000000000000000000000000000000000000000000000000000000000000000000000000000000000000000000000
000000000000000000000000000000000000000000000000000000000000000000000000000000000000000000000000000000000000000000000000000000000000000000000000000000
000000000000000000000000000000000000000000000000000000000000000000000000000000000000000000000000000000000000000000000000000000000000000000000000000000
000000000000000000000000000000000000000000000000000000000000000000000000000000000000000000000000000000000000000000000000000000000000000000000000000000
300000000000000000000000000000000000000000000000000000000000000000000000000000000000000000000000000000000000000000000000000000000000000000000000000000
100300000000000000000000000000000000000000000000000000000000000000000000000000000000000000000000000000000000000000000000000000000000000000000000000000
100130003333000000000000000000000000000000000000000000000000000000000000000000000000000000000000000000000000000000000030000000000000000000000000000000
133110001111303000000000000000000000000000000000000000000000000000000000000000000000000000000000000000000000000030003310000000000000000000000000000000
111110031111101300000000000000000000000000000000000000000000000000000000000000000000000000000000000000000000000010031113000000000000000000000000000000
111113011111131130000000000000000000000000000000000000000000000000000000000000000000000000000000000000000000000310311111000000000000000000000000000000
111111311111111110000000000000000000000000000000000000000000000000000000000030000000000000000000000000000000000113111111003000000000000000000000000000
111111111111111110000000000000000000000000000000000000000000003000000000000013000000000000000000000000000000003111111111331000000000000000000000330300
111111111111111113030030000000000000000000000000000000000000031033000300000311300000000000000000000000000000001111111111111000000000000000000300110100
111111111111111111310010000000000000000000000000000000000000311311300100000111130000000000000000000000000000031111111111111300000000000000000103113100
111111111111111111110310000000000000000000000000000000000000111111133100003111113000000000000000000000000000011111111111111100000003000000003101111130
111111111111111111113113000030000000000000000000000000000003111111111130301111111300000000000000000000000000311111111111111100030001300000031131111110
111111111111111111111111000010000000000000000000000030000031111111111110131111111103000000000000000000000003111111111111111130010031133300011111111113
111111111111111111111111000313000330030000000003000010000011111111111113111111111101030030300000000000033031111111111111111110313011111130311111111111
111111111111111111111111300111030110010003000001300310000311111111111111111111111131013010100000003000011011111111111111111113111311111110111111111111
111111111111111111111111133111313113313331333331133113333111111111111111111111111111311313133333331333311311111111111111111111111111111113111111111111
111111121111121111111111111211122121112221111111111211121111111111111111121111111111111111111212122111111111111211111111211111121211111111111111111111
111111121111211111211111111221111111111111111111111111211111111111111111121111121111111111111221211111112111111111211111111111111112211121211111111111
111111111121111111111111111121111111211211111111111112212111111111111111111111211111111111111111111111111111112111111112111111111111111111111112111111
111121111111121111121111211111112111111111211111122111111111111111111211111111111112211111112111111121111111211111111111111121221111211111111111112111
112111112212111121121111112111111112111111111111111111112112111111111111111111111211111111111111111111111111111121111111112111111111111211111111111111
111111111121112111212111111111111121111121111111111111111111111111111111111111111111111122111111112111212112111112111111111111111111112211111121111111
111111111111111111111212111111111111111111111211111111111121111111111121111111111111111211112111111112111111121111111211112111111111111121211111211121
111111111111111211111121111111111112211121111122211111111111111111211122111111111111212111111121111111111111111211111211111212121221111111211112211111
112111112111111111111121111121111111111111111111111112111111111111112112112111112111111111111111111111121211111111111112111111111211111111111111111111
111111111112111121112111111111122111212111111111121111221111111111121111111112111111121121121111111111221111112121111111211111111221111121111212121111
122111111111211111211111111111211111111111111211112111111211111111111121111111211111112111121111121121221111121111111111111111111111111111121121111111
111111211111111111111111112121111111111211112221111122111121121211111111111111111111111111111111222112111111111121111111111111111111211112111111111111
111111111111111111111121121111111111111111112111111111111112111111111111111111111112112111111211111111111111111121111111111111111111111211211111111111
111121111111111211111111121111111112111211111111121111211111111111111111111111211111211111112111211111111112112111111111211111111111111111111111111111
111112121111111112121112211121112112111111111111211211211111111111111112111111111112111111121111111111111111112111111111121111111111111111111111121112
211111111111111111111111111111111111111212111111111111111211111112111111121111111111121111111111111112111111111111111111111111112111111112111111111111
111111111211211111111221111111111111111111121121112111111211111111111121111111112111121111111111111111111111121111211212111111111121211111111111111111
111111111111112111211111111111111111211111111111111111111211111121211212111111111211112111211111112111111111122111111111211121112111111111111112111112
111111112111111111111211111111111111112211111111111111111221111111111111111111111111111111111111111211111111111111111211111112111111111111121111111111
111111111111211111221111111111212111111111112111111111121111121121121111112112121111211211111111111111111111111112111121112211111211111111111111211112
221111111111112111111211111111111111111111111121111112111111111111111221111111121122211111111211111211111111111111111121111111111111112111111111111111
112111111111211211111122111121121111111211211111111212111112111111111211111111111111111111211121121111111111111111112111212111112122111111111221111112
111112112112111112111111211111111221112111111111111111111211211111111111111111221121111111111111112111221121111121111111111111221211111111111211111111
111111211111111211111111121111111211111212222122111121111111112211212111211211111111212111111111111111111111111111111111112111111111111111111111111111
211111211111111112121112111111111111111111111111121111111111111111111111212111211111111111111111111211112111122211111121112211111121111111211111111111
111111111111111111112111121111211112111111211111121111112111111111111112111111221211111122111112111111111121111111211211111112111111111111111111111211
111212111211111111111112111111111111112111111111112111111111111211111121111111112111111111111111111111211211111111211122211111111221111111111121121111
111111211111111112111111111111111122111111121221112111221211111111112111111211111111111111111111111112111111111211211111211121111221111111112121111111
111112111112111121121112111111111211111111111111111111111121111111121111122112111121111111111111111111111111121111111111211111111111111112111121111111
111111111221111111111112121112111111111111112111111111111111111111112221111111112112111111212112111112211121111111111111111111111111121112211111111112
111111121112111111111111211111112111111211211111111111121111211111211111112111121111111111111111212111112111121111212122121111112111111111111111111111
111121111111111111111111111111111111121212111121121111112111111111111121112111111111111111111121112112111111111111111121212111122111112112111111211111
111111111112112111111121111111111111111111111111111111211121112211111111111111111111111111111111111211211211111112111111111111111211111111111111111111
112111112111111111112112211111211111111111121111111111111111111111111111111212111111111111112111112111111111111121111111121121111111111111111221111111
211111111222111121111111122111212121111121221111111111111111111111211111112121111111111111111111211111111111112111111111121112111111111111211111111111
111112111121111111111111111111112111121111211111111111111211112212111111111111211111211121111111111111111111121111121121111111111111121111111111112111
111111111111211111111111111111111111111111121111111122111111211111121111112111111111111111112121221111111212122121121111121112111111212111111121211111
111211111211112111212111111111111112111111111111111111111211112211112111111211111112211121111111111211111111111111112211111111112211112112211111111112
211111211111111111121121111121112211111111111111111111111121111111111111111111111111111111112111211112211111111112111211111211111111111111111111211111
211111111211121111111111111111211111111111111111111221111111111111111111111121111111111121121211111111211112111211111111111112112111111121111111112112
111111211111111111111111111111111111111112111111111211121111111112111111211112111211211112111111121211111111111111112121111121121111111211111111111121
111111111111111111111111111211111211111111111121111111111112111111121111111111121111211211111211111111211111111111121112112111211211211121111211121121
112111111111111111211111212111111212121111111121111111112211112112111111111111111111111121112111111112211111121111211112111121111211111111111212111111
112111111211111111211111111112112111112111121112211111111111211121111111111111111111111112111111111111111111111212121111111112111111111111121111112112
112121111211212111111111111111111211111111111211111111111111111111111111111111111121111111111122111111211212221111212111112111111112212111111211111111
111111221112111111112111111111121111112111212121111111111111112111112121111111111111111111111111121111121121111111111111111111111111111111121111111121
111111111111111111112111111211111122121111111112111211111111121112121111111111211111111121211111111111112211111111111121111111111211121111121111111121
112111111111211111111111211211112121111111211121112111212111211121111111111112121111111111111111111211111111211111112112111111121111112121111111111111
111211111111211112111111111111111211121111121111111111211121111121111121211211111221111211211112111121111111111111111111112111111111112111111111111111
111121111111111111111112111111121111111111111112111111111111111111212111111111112221112112111111121111111111211111112211112111111111111211111111111111
111111111111111111111211211211112111121121111111121211111111111111111211111112211121111121121211111111111111111111111111121111121111111111111111111111
212111111111111111111111111111111111211211111111111121111111111111112111121111111111111111111211111111111111111111112111111111111111122122121111111111
111111111112111111111111121112111111111111211111111111111111111111111212111111111111111111111112111212111211111111111111111112111112111121211211112212
111111111111111212211222111111111111121111111121121112121111211111111211111111111111111111111212111112111111111111111111111111212111111112111111111121
111111111111112111111111121121111112111112111111111111111111112111221111111111111211112111111112111111121111112112111111111111111112111111111111111111
111111111111111111111111112111111111111211111211111111211111111111111211111111111111111112111111111111111111121112111111121111111111111111111211111111
212111111111112111121111111111112111111111111112211111111111111121112111111111111111211111221111111111111211111111111111121111111111111111111111111111
211121111111111111111112122111112112211111111111111111121111111111111111122111121111211111111121211111111211111221111111111212112111111111121112111111
111122111211111111111111222121111111111221111121111111112211111111111111111111111111121111111111211111111111111111111111111111121111112111112111121111
112111111111111111111111121111211111111111121211111111111211111222111121121111111111111111221111112111111111111211111111111121211112111111111211111111
111111111111112111111111112111111111112111111211112122111111111121121111121111111111111111111211211111111111211111111111112111122111111111111111111212
111111111111111111111111122112111111111111112111121111121111111111122111111111111111121111111211111111211111112121111111121112111111111111111111111121
112111111211121111111211111111111121111111111111111122111121111111111111111111111111111111111111111111111111121111221121111111111211211111111112111111
111111111111211111112111111111111111111111211111111111211111211111111111111111121121112111111121111111111111111211111111111111111112111211111112111111
112111111111121112111111211211111111221111121111111111111111111111111111111121111121111111111211111121211111111111111111111111111111111111111111111111
111111111122111111111111111121111111111111221111111111112211111111122111112111111111111111111111111111111111111111211211111111111111111112111111112111
111211111111112111111112121111112111221211121111211111212111121111111111111111111111111111211211111121111212111111111111211111111121112211111111121111
111211212111111111111111111111121111111122112111111112112111111111121111211211111211111111111121111111111121121111112111111121111111111121121111221111
111112121111111121111121111111111111111111111111111111111111211111112111121111112111111111111112121211111111112112121111111111121111111111111111111112
211212111111111112111112111112111211211111111121111111111112111111111111111111111111111111111112111111122111111111111111111111111111111111121121112121
211111111111211111111121112212111122212121111111111211211121111211111111111111111111112111111111111111121111111111111111111111111111211111111111121111
111111111111111111111111211211111112111111111111211111112111111111111111221111121121111111111111111111112111111121112111111111111111111121121111111111
111111112111111111111111111112211112111111111111111111111121121122112111121111111111111111111111111111211112111111111111121111121111211111211111111111
111111111121121111111111111111121211211121111211111211112111111221211111212211121111122111121111112121111111111212111211111121111111111111111111111111
212111121111111111111111111112111111211112111111111112211111111211111112111121111121111111111121111111111111111211111221111111111111111111111111211111
111111112111111111211121211111211111111112211111211111111111111111111121111111111211111111111112111111111111211111111111211111211211111111211112111211
211111111111111111111111121111112211112111121121111111111212112112112111111111111111111111111111111111111122111111111111111122121111122111221112121111
111211111211111111111111111111111111111112111111111121112111111111111111111111221111111111111111112211111121211121111111111112122211111111222111212211
111121111111111111111111111111111111112111111111112111121111111111111111111111111112112121111111111121111111122112212212111111111111111111112111111111
211111111111111112211111111111111111111121111111111111111111111111111111121111111112121111111111111111112111112111111111112112111111112111121121111111
121112211211111111211111111111111111112112111111221112111121111111211111212111111111111111121111111111111111111111111111112111111111211111112111111111
111111111111111111111121211111121111111111212111112112111111111111111111111211211112111111111121112111111111122121111111122111111111112111112111112111
111111111122111121111111111111121111111111121111111111121112112112112121111111221121111212211112121112111112111111212111121111111111111111111111211112
121111111111111121111111121111111111111111111121211111111111121111112111111111111121111211111112111111111122111111111111111112111111111112211111211112
121121111111111111111121111111221211121121212111111111112111111111111111111111111111112111111111112111111111111121212111211111111211111111111111111111
211111111112111111111112111111111111211111111111111111111111111211211111112112121111211111111111211111212111111112111111111121111121111111111111112111
111111111111121111111211121112121111111111121112111111111112211211221111111111111111111111111111111111111112211111111121111121111121111112111111211111
111111111111111111111111112111111111111111111111111111111111111211111121111111111121121111121111121211121111211111121111111111111112111121211211121112
121121111111111111121111112211111121111111111111111111111111111111211211111111111111111211111111112111111211211211112111111111111112221112111111112112