000000000000000000000000000000000000000000000000000000000000000000000000000000000000000000000000000000000000000000000000000000000000000000000000000000
000000000000000000000000000000000000000000000000000000000000000000000000000000000000000000000000000000000000000000000000000000000000000000000000000000
000000000000000000000000000000000000000000000000000000000000000000000000000000000000000000000000000000000000000000000000000000000000000000000000000000
000000000000000000000000000000000000000000000000000000000000000000000000000000000000000000000000000000000000000000000000000000000000000000000000000000
000000000000000000000000000000000000000000000000000000000000000000000000000000000000000000000000000000000000000000000000000000000000000000000000000000
000000000000000000000000000000000000000000000000000000000000000000000000000000000000000000000000000000000000000000000000000000000000000000000000000000
000000000000000000000000000000000000000000000000000000000000000000000000000000000000000000000000000000000000000000000000000000000000000000000000000000
000000000000000000000000000000000000000000000000000000000000000000000000000000000000000000000000000000000000000000000000000000000000000000000000000000
000000000000000000000000000000000000000000000000000000000000000000000000000000000000000000000000000000000000000000000000000000000000000000000000000000
000000000000000000000000000000000000000000000000000000000000000000000000000000000000000000000000000000000000000000000000000000000000000000000000000000
000000000000000000000000000000000000000000000000000000000000000000000000000000000000000000000000000000000000000000000000000000000000000000000000000000
000000000000000000000000000000000000000000000000000000000000000000000000000000000000000000000000000000000000000000000000000000000000000000000000000000
000000000000000000000000000000000000000000000000000000000000000000000000000000000000000000000000000000000000000000000000000000000000000000000000000000
000000000000000000000000000000000000000000000000000000000000000000000000000000000000000000000000000000000000000000000000000000000000000000000000000000
000000000000000000000000000000000000000000000000000000000000000000000000000000000000000000000000000000000000000000000000000000000000000000000000000000
000000000000000000000000000000000000000000000000000000000000000000000000000000000000000000000000000000000000000000000000000000000000000000000000000000
000000000000000000000000000000000000000000000000000000000000000000000000000000000000000000000000000000000000000000000000000000000000000000000000000000
000000000000000000000000000000000000000000000000000000000000000000000000000000000000000000000000000000000000000000000000000000000000000000000000000000
000000000000000000000000000000000000000000000000000000000000000000000000000000000000000000000000000000000000000000000000000000000000000000000000000000
000000000000000000000000000000000000000000000000000000000000000000000000000000000000000000000000000000000000000000000000000000000000000000000000000000
000000000000000000000000000000000000000000000000000000000000000000000000000000000000000000000000000000000000000000000000000000000000000000000000000000
000000000000000000000000000000000000000000000000000000000000000000000000000000000000000000000000000000000000000000000000000000000000000000000000000000
000000000000000000000000000000000000000000000000000000000000000000000000000000000000000000000000000000000000000000000000000000000000000000000000000000
000000000000000000000000000000000000000000000000000000000000000000000000000000000000000000000000000000000000000000000000000000000000000000000000000000
000000000000000000000000000000000000000000000000000000000000000000000000000000000000000000000000000000000000000000000000000000000000000000000000000000
000000000000000000000000000000000000000000000000000000000000000000000000000000000000000000000000000000000000000000000000000000000000000000000000000000
000000000000000000000000000000000000000000000000000000000000000000000000000000000000000000000000000000000000000000000000000000000000000000000000000000
000000000000000000000000000000000000000000000000000000000000000000000000000000000000000000000000000000000000000000000000000000000000000000000000000000
000000000000000000000000000000000000000000000000000000000000000000000000000000000000000000000000000000000000000000000000000000000000000000000000000000
000000000000000000000000000000000000000000000000000000000000000000000000000000000000000000000000000000000000000000000000000000000000000000000000000000
000000000000000000000000000000000000000000000000000000000000000000000000000900000000000000000000000000000000000000000000000000000000000000000000000000
000000000000000000000000000000000000000000000000000000000000000000000000000000000000000000000000000000000000000000000000000000000000000000000000000000
000000000000000000000000000000000000000000000000000000000000000000000000000000000000000000000000000000000000000000000000000000000000000000000000000000
000000000000000000000000000000000000000000000000000000000000000000000000000000000000000000000000000000000000000000000000000000000000000000000000000000
000000000000000000000000000000000000000000000000000000000000000000000000000000000000000000000000000000000000000000000000000000000000000000000000000000
000000000000000000000000000000000000000000000000000000000000000000000000000000000000000000000000000000000000000000000000000000000000000000000000000000
000000000000000000000000000000000000000000000000000000000000000000000000000000000000000000000000000000000000000000000000000000000000000000000000000000
000000000000000000000000000000000000000000000000000000000000000000000000000000000000000000000000000000000000000000000000000000000000000000000000000000
000000000000000000000000000000000000000000000000000000000000000000000000000000000000000000000000000000000000000000000000000000000000000000000000000000
000000000000000000000000000000000000000000000000000000000000000000000000000000000000000000000000000000000000000000000000000000000000000000000000000000
000000000000000000000000000000000000000000000000000000000000000000000000000000000000000000000000000000000000000000000000000000000000000000000000000000
000000000000000000000000000000000000000000000000000000000000000000000000000000000000000000000000000000000000000000000000000000000000000000000000000000
000000000000000000000000000000000000000000000000000000000000000000000000000000000000000000000000000000000000000000000000000000000000000000000000000000
000000000000000000000000000000000000000000000000000000000000000000000000000000000000000000000000000000000000000000000000000000000000000000000000000000
000000000000000000000000000000000000000000000000000000000000000000000000000000000000000000000000000000000000000000000000000000000000000000000000000000
330000000000000000000000000000000000000000000000000000000000000000000000000000000000000000000000000000000000000000000000000000000000000000000000000000
110000000000000000000000000000000000000000000000000000000000000000000000000000000000000000000000000000000000000000000000000000000000000000000000000000
113000000000000000000000000000000000000000000000000000000000000000000000000000000000000000000000000000000000000000000000000000000000000000000000000000
111300000000000000000000000000000000000000000000000000000000000000000000000000000000000000000000000000000000000000000000000000000000000000000000000000
111130000000000000000000000000000000000000000000000000000000000000000000000000000000000000000000000000000000000000000000000000000000000000000000000000
111110000000000000000000000000000000000000000000000000000000000000000000000000000000000000000000000000000000000000000000000000000000000000000000000000
111110000000000000000000000000000000000000000000000000000000000000000000000000000000000000000000000000000000000000000000000000000000000000000000000000
111113000000000000000000000000000000000000000000000000000000000000000000000000000000000000000000000000000300000000000000000000000000000000000000000000
111111000000000000000000000000000000000000000000000000000000000000000000000000000000000000000000000000003100000000000000000000000000000000000000000000
111111000000000000000000000000000000000000003000000000000000000000000000000000000000000000000000000000031130000000000000000000000000000000000000000000
111111300000000033000000000000000000000000001000000000000000000000000000000000000000000000000000000000011110000000000000000000000000000000000000000000
111111100000003311300000000000000000000003331300300033000000000000000000000003000300000000000000000000311113000000000000000000000000000000000030000000
111111133000001111100000000000000000000001111103100011000000000030000000000001003100000000000000000000111111000000000300000000000000000003300310000000
111111111300031111100000330030000000000031111101100311000030000010000300000031031103000000000000300003111111000003333100000030000000003031103110000000
111111111100011111130000110013000030003011111131130111300010030313303100330011311131003000030033100001111111300001111100000010003000001311101113303300
111111111133311111113333113311333313331311111111113111133313313111131133113311111111331333313311133331111111133331111133333313331333331111131111131133
111112111111112111121111122111111111111111111121112111122111211111111111112111111111111111111111111111111111121211121111111111211111211111121111111211
111111111111111121211111112112111111111111111111112211211211111111111211111111111111111121111111211111112211111111111111111121111111111111111111111111
111211111112111111111111212111111121211121211111211111111111221111212121111111111111111111111111111211111111111111111111111111121111111211111111121111
111221111111111122211111111211121111111111121112111111211111111111111111111111111111111112111121111121111121111121112111111211111111112111112111111111
121111122211111111111121111111111111121121111111121111221111111211112121111121111211111111112111211111121111111121111111211111111111112111111111121112
211121111121112111112112111121111111111111111211121111111111221111111111111111111111221111111111111111111111111111111111111111111111111111122111112112
111111112111112111111111111111111111121111211221111111111121111111111111121211111111111111111121111111111111111111111111111111211111111111111111121111
111111111121211111112111111111111112211112122111211111111111211111111111111111111121112112111111111122111211111111111111112221211111111111111111111111
111211111111111111211111111111111212111121111111111121111111111221211112111111112111111121111111111211111111111122112121111111111111111111111111121112
122111111111122111122112121211111111111121111211111111111111111211112111111211111111111111111111121111211121111111121111111121121111121111111111111112
111211112211111111211111111111121111111111111111111111112111111111111111111122111211111111111121121111111111111111211121111121111111111111211111212211
111111111111112111111111111111111111112111121212111211111111221111211111111111112111111111121111121111112211111111111111111211111111112111111111111211
111111211111111111111111112211111112111211211111211111111111111112111111111121111111111111111111111111111121111111111111111112111111111211121111121111
111111122111111111111111111111111111111111111111111111211112111121111211111111111111111111112111111111111111111122111111111111121111111111211111211111
111111112122111212211111111111112111111111111111111111221111211111121111111112111222111111111111112111211111111212111112111111111111111212211211111111
111111111111211111112121111111111111111111111111111111121212112112111111111121121112111111112112121111111111212111111111112111121211111112112111111212
211211111111111111111111111112111111121111111211111111111111111111211121111121111111111111111121111111112111111112111112211111111111121112111211111111
121211111112111111111111111211212111211221111111112111111211211111112111111111111111111111111112111111111211121111111111111111121111111111111111121121
111111121111112111112122111112111111112111112111111111111112111112111111111111111211111111121112121111111221111111121111111111111121121111111111111111
111211111112211111111111111111111212111111111111111111111111111111111111111111111111111111111111111111211111111112112121111112111111111111111111112111
111111111111111121211111111111112111211111111111111111111111111111111111111221211111111111111112121121111122112111111111111111121111111112121111211111
211111111111211111111111111111111111211111112112211111111111111111112121122111111212111111111111111111111121111211111111111111111111111211111211111211
111111111111111211111112111111221112111121111121111111121111211111111111111111111211111111111111111121111111111111111111111112111111111211211111111111
111211121111122212111111111111211111111111111111111111111111211111111111111221111112111211121111121111112111111111211111111211111111111111111211111111
111111111111111111111111211121111111211111111111121111222111111111111111112121211111111111111111112111111111111121111111111111111111111111111111211121
211111211111111121111112121112121111112121111112211221111111111111121111111111212111121111111111112112211121111111211111211111111111121112111111112111
111211111121121112111111121112221111111111221221111111121111112111111111111111111112111111111111111121111111111111111111111121111111111211111111111111
211111111112111121221121121111111111111111112111111121111211111211112111211111112111111111111111111211121111111111111111111211111111211111111111121111
111111111111112111111111112111111112111111111111111111111111111111121212211121111111111112111111111121121111111112111111111111111122111211111111111111
111111112111212111211111111111111121111111121111111122111111121111211111111121121111111111111121111111111112112111221111111112111111121111112111212111
121221112111111111111111121111111111211121111112111111111112111211111111111111211111211111112121121111111111121111212111121211111111111111112111211211
111121212112111111112111111111111111111111221111112111111111211111111111111111221211111112111111111111111111111111111121111112212122211112122111111211
111112111111121121111111111111111111111111121211111111111111111111112111111112122111111212111111112211211111112111121122111212111111111121111111111111
121112111111111121111111111122111111111211111112111111122111111111111111112221111121121111111111112111111111111111112211111112111121111111111111111111
111111221121111111211211111111111111121111111211112211111111112111111111112211111111111111211122111211111111111111111111211111111111121111112121111121
111111111211111121111111121111111111111111111111221111221122111111111111111111111112112111111111121211111111112211211111121111111111111121111111211211
111111111111111111111111211111111112111112111111121111111111121111111111111211111111111111111111112111111111111111112112211111112111121121121111121111
111111111111121111111111111111122111211111121121111111111111111111111111111111211121111211121211121111111111111111111111212111111111211111111112121111
111121111111111111111111111111111111221221211111111211111111111111121111111121111112112112111212111121111211221212211111111211111111111111211111112111
111111121111111111111111111111111111112111111111122211111111111211112111111111111112121111111111211221111211121111111121112121111111111111111111111112
211111121211111111111111112121111111111111121111111111121111111211111111111122111111111111111111111111111111111111111111111111111112211121111111111111
211111111211111111111122111211111112111111121111111211111111121111112111122111111111111111111121111111111112111112221122211211112211112111111111121111
111111111121111111111111211111111111111111111111111111111111111111111111111121211111111111121111112111111111111211111111121121211211111112221111111111
111211211112111111111121121111111111111111212111211111112111221211111111111111111121111111211111111211121111111111211111111121111111111111111112111111
111111111111111121111111111111111112111121111111111111111111111111221111111211111112111121111111111111111111111111111111111122111111212111111221111111
111111111211111212211111111211121121112111111111111111111111112111211111111111111111111111121111111121111211121111112111111111211211111111121111112111
212111111111111111111111111111111111112112111211111112111121211111111112211221121111111111111112111112111111111111121122111111111111112111111111111211
111111111111111211121111111111111111112211111122211111111111121112111111111112111111111211121112211111111111111112111221212111121121211211111111111111
111111111111111121111111111211111111111111111211112121111111211111111111211111112111111111111111111111111111121111111111111111121111121111111111111111
111112111111111111111121112111112112111111111111111111121111211111111111112111111111111121111121111111121111111111111111121112111111111111212112111221
121111111121111111111111111111111111121111111111111211111111111111111111111111111222111111111111111111111111111122111111112111121211111122111111111111
111111211111111111111111111121112111111111121111121112112112111111211111111121112111111111111111111111111111111211111211211111211111111212111111212111
111111211111121111111111112221112111121111111211211121121111111211111121111111111111111121111111111111121111212211111111111111112111111111111111111111
211111111111111111111111111111211111111111111111111121111122111111111111121211111111111111111121111211112111112212111121212111111111111222111111111112
112212111111111211121211111111121111111111111121111111111111222111212112121111111121111121121111111111211111111121111111111111111111112111111211111111
111111111111112212112111121121111211111121111111211211111111111111112111111111111111111111112111111111111111211212211211111111111111111212111111111111
111111111111111111111111111111111111111111111111111111121121111111121111111111111121111111121111111211112111211111111111111111112111122121211112112121
111111211121111111111111111121111111111111111111111211111111211121221111121111111211111111112111111111111111111122121112111122111111111121111112111121
111111121112211121112111111121111111111211111211211121111111111111111111111211111111111121111111111111111112112111112112111111111111111111111111112111
111211111111121111111111111111221112111111111112112111111111111111211122122111111111121112111111112211111211212111111211111111211121111111111121111111
111111111111111211111111111111121111211111211111121111112112121211111111111121111121111111112121111111111111111112111211111122112111111211111112121211
111111111111111211111111111111111111112112122111111111111111111111111112111111111111211111111121221211112111111121111112111112111111111111111111111111
111111121111111211111111121111111111111111111111111111111111211111122211111111111111121112212211211111111112211111211111111121111111111211111111112112
221111121111112111122111111122112111112111111111111111112211121111111121111111211111111111121121211111111111111111122111111112122111111211111121212111
111111112111111111111111111111211112111121111211111121111121111121111111111111211111111111111111111111111211111121121112111111111111111211111121111112
111111112121111111111111211111111112111111112111111211111111111111111111212211121111111111112111211111111111111111111111122111111111111212111111111112
111111111111121122111111111111111111212111111111111111211111212211111111122121111111111111111211111112111121211111211111111111111111111111111112111111
111111111111111211111111111121112211121112121211111112111111111111111111111111111121111111111211111111111111111211111111111111111111211112111121111222
111212111111111111112111111111211111111211112111111111111121111212111111121111111111211111111112111111111211111111211111111211211221111111111112121111
111111111111112111221211111111111111112111111112111111111112111112111121111212211111111111211111111111111111111111121111121211111111111111211111121111
111111121111112111111112121111111111111111111111211111112112111112221122111111111111111111112111111111121111111111111211112112111121112112211121111111
211111111111111211111111111211122211112111111111111111211111111111111111111111111111112211112111111111111111112111111111211111121111111111211111111111
111111111121111112111111111111121111111111221211112112111111111111111111111111111111211111111111111111111111121122122211111111111222111111112111111111
111111111112111111111111111111111111211122111111121111111111112112111111221111111121121111111111111112111111111111121111221111111211111111111111111112
121111111121212211111112111211111121111111111111111112211111211111111111111211211111111111111111111212111111111111111111111111111111111111111121111111
111122111111111111111111111111121111111111212221111111121111121111111112111111111111111111112111111211111111111111111111112111111111121111111111111111
111211111111111111112111121111111111112111112111111121111121111111211112111111111211111111111111111111111111111121212112111111111111211111211212111111
111111111211111111212111111111111112111111111111111111122112111111112111211112111211111111111112112112111111122112121111112112111111111111111111111111
111111111111111111121211111111111111112111111111111111112211111111111111211111111111111111111121111111111121211111211111111121211111111221112111111111
111111211111111111111111212111121121111111111111111111111111112121111111121111111112111111112112111111211212212111111111121111111111111112111111111111
212111111221121111211111111111111121111112111111111111111111111111121111111111121211111111121111111111111111211111111211111111121111111111211111111112
121111111111111111111211112211111111121111211111111122111111111111111111111111112111111211112111111211121121111111111112111111112111111111112111111111
121111111211111111111212111111111111111111111111111111211111111111111211121111122112111112121211111112121211111111111111211111111211111121121211121112
211111111212221111212211111121211211211121211121212211112121111111111222111111211111111211111111111112111111111112112111111121111112111111112111212111
111121211121111111111111111111211111111111211111111111111111111111211121111111121111111112111111211111111111211111111111111111122111111111111221111111
111111111111221111112111111111112111111221111211112111111111121121111111211111111111221111212111121111121111212111111111121111111211121111111111112121
111111111111211111211112111111111111111111211111111121111121222121121111112111121112211112111111111212111111121111221111111121121112111111211121211211
111111111112111121111111111111111211212111111111111111111111111111111111111111121121111111211111111111111111211111111111111121111121121111112111111111
111111111111111112111112212111111211111111111111111111111111111121111111112111121121111112112111111121111121112111112111111111111111222111111111222111