0000000000000000000000000000000000000000000000000000000000000000000000000000000000000000000000000000
0000000000000000000000000000000000000000000000000000000000000000000000000000000000000000000000000000
0000000000000000000000000000000000000000000000000000000000000000000000000000000000000000000000000000
0000000000000000000000000000000000000000000000000000000000000000000000000000000000000000000000000000
0000000000000000000000000000000000000000000000000000000000000000000000000000000000000000000000000000
0000000000000000000000000000000000000000000000000000000000000000000000000000000000000000000000000000
0000000000000000000000000000000000000000000000000000000000000000000000000000000000000000000000000000
0000000000000000000000000000000000000000000000000000000000000000000000000000000000000000000000000000
0000000000000000000000000000000000000000000000000000000000000000000000000000000000000000000000000000
0000000000000000000000000000000000000000000000000000000000000000000000000000000000000000000000000000
0000000000000000000000000000000000000000000000000000000000000000000000000000000000000000000000000000
0000000000000000000000000000000000000000000000000000000000000000000000000000000000000000000000000000
0000000000000000000000000000000000000000000000000000000000000000000000000000000000000000000000000000
0000000000000000000000000000000000000000000000000000000000000000000000000000000000000000000000000000
0000000000000000000000000000000000000000000000000000000000000000000000000000000000000000000000000000
0000000000000000000000000000000000000000000000000000000000000000000000000000000000000000000000000000
0000000000000000000000000000000000000000000000000000000000000000000000000000000000000000000000000000
0000000000000000000000000000000000000000000000000000000000000000000000000000000000000000000000000000
0000000000000000000000000000000000000000000000000090000000000000000000000000000000000000000000000000
0000000000000000000000000000000000000000000000000000000000000000000000000000000000000000000000000000
1111111000000000000000000000000000000011101000001011010100000000110110000000000100000011000000000000
1111111100000000000000000000000000001111101100001111111100000000111110000000010100000111101010000000
1111111100100000000000000000110001111111111100011111111110000011111111000110011111101111101110000000
1111111111101000000000001010110001111111111110011111111111110111111111010110111111101111111111000011
1111111111111100000000111011111011111111111110111111111111110111111111111111111111111111111111000011
1111111111111100000000111111111011111111111111111111111111111111111111111111111111111111111111110111
1111111111111110000001111111111111111111111111111111111111111111111111111111111111111111111111111111
1111111111111111001001111111111111111111111111111111111111111111111111111111111111111111111111111111
1111111111111111011111111111111111111111111111111111111111111111111111111111111111111111111111111111
1111111111111111111111111111111111111111111111111111111111111111111111111111111111111111111111111111
1111111111111111111111111111111111111111111111111111111111111111111111111111111111111111111111111111
1111111111111111111111111111111111111111111111111111111111111111111111111111111111111111111111111111
1111111111111111111111111111111111111111111111111111111111111111111111111111111111111111111111111111
1111111111111111111111111111111111111111111111111111111111111111111111111111111111111111111111111111
1111111111111111111111111111111111111111111111111111111111111111111111111111111111111111111111111111
1111111111111111111111111111111111111111111111111111111111111111111111111111111111111111111111111111
1111111111111111111111111111111111111111111111111111111111111111111111111111111111111111111111111111
1111111111111111111111111111111111111111111111111111111111111111111111111111111111111111111111111111
1111111111111111111111111111111111111111111111111111111111111111111111111111111111111111111111111111
1111111111111111111111111111111111111111111111111111111111111111111111111111111111111111111111111111
1111111111111111111111111111111111111111111111111111111111111111111111111111111111111111111111111111
1111111111121121111111111111111112211111111122111111111121111112111121111111111121121221111111211111
1121111111111111111111111111111112111121121111111212111112111111111111111121211111112111111111111211
1111121112211111111111111111111212211121111111222111111111111112211111111111111111111111111111211111
1111111112121111122121221111111111111111122111111111111221111121111112211111211121121111111111121111
1112111111111111111121111211122111121121111111111111111211111111111112111111211121111111212111111111
2211111111111111121111222112211211111111111111111121111111111221111111211111111111111111121111111112
2121111111111111211112121111121111111211121111211211111111111112211111111111111211111121122111121111
1111111111121111111211111111111112121121211121121111111111111112111111111111111111121111112111211111
1111112112111111211111121111111111112111111111111111111111111111111211111111111212111111111112111111
1111111211112121111111111111111111121121111111111221111111211211111112111111121211111111111211111211
1121111211122221111111111122112111111111111111111211111111211212111112111111121211111111111111211111
1121111111111122211111112111111111111111121211111121112111211111111121111111111211111211111211112111
1111111111111211111111111111111111111111111112111111111211111111111111111111111111121111111111121122
1111111111112111111111111112111111112111211121111111111111111111111111121111111111111111111111111111
1111111211121111111111121111121111111111111111212111211112111111111111111221111211111211212111111111
1111211111112111111111111111111112211111121112211111111121111111121111111121111111112111121212122111
1111121111112111111211111111111111111212211121112111111211111111111111111111111111111112111111111111
1111111111121121111111112111112211111111112121111112111111111121111111121112111221111111111111111211
1111111112111112111111111211111211111111111111111111111111111212111111121111111111111111111121111111
1211122111111112112111211221111121111111211111111111111121111211211111112111121111111211111211111111
1111111111211112111221211111121111111211111111111111111112121111112111111112121111111121111111111121
2211111111121111111111111111111122211111111111111111112111112111111121111111111111111211111111111211
1111111111122111111211111112121111111211211111121111111211111111112111121111111111211111112211111211
2111111111111111111111111111121111111221111111121111211111111111121111111111111111121111121211121111
1111211111111111211112111111221111111121111111111121111112111121111111121111112111111211121111111111
1121112111111112111111111111112112121111111112111121111111121111121111211211121111121211111111111121
1111111111211211111111111111112111111111211111111121111211111111112111121111111111212112112111111111
1211111211112111122111111111112111211111111111111212121211112111111111111211111121111111111121111211
1111111111212111111111121111111111111111121121111111111111111111111111221111121211111111211111121111
2111111111111221111221111111111111111111111111111111121211111111111111112111111111111111111111211111
1111111111121111121111111121111211111111111112121211111111111111211111111112211111111111111111112211
1111211112112111221111111211121121111211211111121111111121111112112111122211111111112211211111111111
1211111211211111112111111111212111111111111111111111111111111111111111112111111111111111221111111111
2111121112111211111111122111111112121221111111111111111111211211211121111121111121111111211111111111
2111111111111111111111111111211111111211111211121111111112121112111211111111111111111111111111111121
1121211111121211211111111111112111112111111111211112211111111111121211112111112111111111111121121121
2122111111211111121121112121111112111112211111111111112111111111121111121112121111111211111111111111
1111111111111111111111121111111121111111111111111121111211121112112111211111111111111111121111111111
1111111111111111111112221112112112111111112211111111111111111111121111111111121211111111111111212112
1111111112111111111112111111111121111111111111111111111111111111111111111122111111111111111111121211
1121111111111111111111111111111112111111121111121111111111211112121111111111112111112111121111112211
1111111211111111111111211111111111112111111212111112111112112112111111111211111111121111111111111111
1111111111111111111111111111111112121111111111112112112111111111121111112111111112112121111112121111
2211111211122111111211112111111121111121111112111112111111111111211111111111111111111121211111111111
2212111111121121111111111221122111121111111111212112211121111111122112111111111111111121111111121211
1112112211111111111111221111211111122111112112111111111111111111111111111111111111211111111121121111
1111111111111112111121111111211121111112111111111111111121111111111111111211111111111111111111111111
1122111211111111111111111111111111111111111112111111111111111111112111111111121211111111112111121111
1111111111111111211111111111111111111111111111111111111111212211121111211111111111211111111122111121
1211111111111111121111111111111111121111111221212121111111111121111222121121111111112111111211121111
1112111122112111111111121112121112121121112111212111111111111112112111211111111111112111111111111111
1111121121111111112111111111111211111121111211111111111111211211111211111111111111211111121111111111
1111111111112111111211111121111211111211111111111112211111111111111111111111211121111111111111111211
2111111111121111111112111111212111111111111111111111111111111111111111111121111111111211121211111111
1111111111112111121112112111111112111111111111111111112121211111112212111111111111111122111111111111
1111111121112111111111111221112111111211211121111121111111221111111111212111211111211111112111111111
2121111111111222212111111111111111111211111112211111111112211111211121111111111111111111111111111111
1112111211111121211112211111121112111112111111111122121112211112121111111111111212111212122111121211
1111111112111111111111111122111111111121111111111111112112111111111111111111211111111111111121121111