000000000000000000000000000000000000000000000000000000000000000000000000000000000000000000000000000000000000000000000000000000000000000000000000000000
000000000000000000000000000000000000000000000000000000000000000000000000000000000000000000000000000000000000000000000000000000000000000000000000000000
000000000000000000000000000000000000000000000000000000000000000000000000000000000000000000000000000000000000000000000000000000000000000000000000000000
000000000000000000000000000000000000000000000000000000000000000000000000000000000000000000000000000000000000000000000000000000000000000000000000000000
000000000000000000000000000000000000000000000000000000000000000000000000000000000000000000000000000000000000000000000000000000000000000000000000000000
000000000000000000000000000000000000000000000000000000000000000000000000000000000000000000000000000000000000000000000000000000000000000000000000000000
000000000000000000000000000000000000000000000000000000000000000000000000000000000000000000000000000000000000000000000000000000000000000000000000000000
000000000000000000000000000000000000000000000000000000000000000000000000000000000000000000000000000000000000000000000000000000000000000000000000000000
000000000000000000000000000000000000000000000000000000000000000000000000000000000000000000000000000000000000000000000000000000000000000000000000000000
000000000000000000000000000000000000000000000000000000000000000000000000000000000000000000000000000000000000000000000000000000000000000000000000000000
000000000000000000000000000000000000000000000000000000000000000000000000000000000000000000000000000000000000000000000000000000000000000000000000000000
000000000000000000000000000000000000000000000000000000000000000000000000000000000000000000000000000000000000000000000000000000000000000000000000000000
000000000000000000000000000000000000000000000000000000000000000000000000000000000000000000000000000000000000000000000000000000000000000000000000000000
000000000000000000000000000000000000000000000000000000000100000010000000000000000000000000000000000000000000000000000000000000000000000000000000000000
000000000000000000000000000000000000000000000000100000000000000000000000000000000000000000000000000000000000000000000000000000000000000000000000000000
000000000000000000000000000000000000000000000000000000000000000000000000000000000000000000000000000000000000000000000000000000000000000000000000000000
000000001000000000000000000000000000000010000000000000000000000000000000000000000000000000000000000000000000000000000000000000000000000000000000000000
000000000000000000000000000000000000000000000000000000000000000000100000000000000000000000000000000000000000000000000000000000000000000000000000000000
000000000000000000000000000000000000100000000000000003000000000001000000000000000000000000000000000000000000000000000000000000000000000000000000000000
000000000000000000000000000000000000000000000000000000010000000000000000000000000000000000000000000000000000000000000000000000000000000000000000000000
000000000000000000000000000000000000000000000000000060001000000000000000000000000000000000000000000000000000000000000000000000000000000000000000000000
000000000000000000000000000000000000000000000000000000000000010000000000000000000000000000000000000000000000000000000000000000000000000000000000000000
000000000000000000000000000000000000000000000000050000000000000000000000000000000000000000000000000000000000000000000000000000000000000000000000000000
000000000000000000000000000000000000000000000000000000000000100000000000000000000000000000000000000000000000000000000000000000000000000000000000000000
000000000000000000000000000000000000000000000010000000000100000000000000000000000000000000000000000000000000000000000000000000000000000000000000000000
000000000000000000000000000000000000000000000000100000001000100000000000000000000000000000000000000000000000000000000000000000000000000000000000000000
000000000000000000000001000000000000000000000000000010001100001000000000000000000000000000000000000000000000000000000000000000000000000000000000000000
010000000000000000000000000000000000000000000000001000000100000000000000000000000000000000000000000000000000000000000000000000000000000000000000000000
000101000000000000000000000000000000000000000000000000011000000000000000000000000000000000000000000000000000000000000000000000000000000000000000000000
000000000000000000000000000000000000000000000000000111001100000000000000000000000000100000000000000000000000000000000000000000000000000000000000000000
000000100000000000000000000000000000000000000001000000011100000000000000000900000000000000000000000000000000000000000000000000000000000000000000000000
000000000000000000000000000000000000000000000000000000001101000000000000000000000000000000000000000000000000000000000000000000000000000000000000000000
000000000000000000000000000000000000000000000000200000001100000000000000000000000000000000000000000000000000000000000000000000000000000000000000000000
110000000000000000000000000000000000000010003020101110001100000000000000000000000000000000000000000000000000000000000000000000000000000000000000000000
110000000000000000000000000000000000000000000000011020011000110001000000000000000000000000000000000000000000000000000000000000000000000000000000000000
000000000000000000000000000000000000000000000000000000000000000000000000000000000000000000000000000000000000000000000000000000000000000000000000000000
000000000000000000000000000000000000000000000000000100000000000000000000000000000000000000000000000000000000000000000000000000000000000000000000000000
000000000000000000000000000000000000000000000300000000000001000000000000000000000000000000000000000000000000000000000000000000000000000000000000000000
000000000000000000000000000000000000000000004200000000000000000000000000000000000000000000000000000000000000000000000000000000000000000000000000000000
000000000000000000000000000000000000000000244130000000000000000000000000000000000000000000000000000000000000000000000000000000000000000000000000000000
000000000000000000000000000000000000000000442110000000000000003000000000000000000000000000000000000000000000000000000000000000000000000000000000000000
000000000000000000000000000000000000000004444400000000000000001000000000000000000000000000000000000000000000000000000000000000000000000000000000000000
000000000000000000000000000000000000000044442213000000001000011003000000000000000000000000000000000000000000000000000000000000000000000000000000000000
000000000000000000000000000000000000000424424102000000003030321331000000000000000000000000000000000000000000000000000000000000000000000000000000000000
000000000000000000000000000000000000040244224411300030031303211112000000000000000000000000000000000000000000000000000000000000000000000000000000000000
300300000000000000000000000000000000044444444411100010311111111111300000000000000000000000000000000000000000000000000000000000000000000000000000000000
103130000000000000000000000000340000444444444111130310111012111211100000000000000000000000000000000000000000000000000000000000000000000000000000000000
131110000000000000000000300003140200244444444111110113121112111111130000000000000000000000000000000000000000000000000000000000000000000000000000000000
111120000000000000000000100031144404424444444411113221111121212111113000000000000000000000000000300000000000000000000000000000000000000000000000000000
111113330000300030000033200011144444224444244211111111111111211111121000000000000000000000030003133000000700000000000000000000000000000000000000000000
111211110303130310000311130311144444444442244111111111111111121111121000300000000000000003010031111300000670700000000000000000000000000000000000000000
111111210101110213003111110122244444444444244411111111111121111111211303100000000000000001313311212230003667670000000000000000000000000000000000000000
122121113131213112001112113111144444422444444411122111121111111111111131100003000000000031111111111110001666660000000000000000000000000000000000000000
121111111112111112031111111211144244424444424211112112121111121111111112130001030000300011111211111110031666660000000000000000000000000000000000000000
111111111121111112311111111111442444444444244411111111111111111111111111110331310033130311111112122113011266667000000000003000030000000000300000000000
111112111111111111111111111111444444444444224111121121211111112111121111110111113011110111112121111111311666666700000000031303013000033300100000000000
121111111111221111112121111112442444444444444411112111111211111111111111113111111311113111111111111111111166666600000000711101311330011103133000300000
121112211211211111111211111111144444444444444121112111111111111111111111111111111111111121111211112121111266666600700007611131111113321201111330130000
111111111111111121111212121112444444244424442211111111111111111211111111111122111111111111111111111111112166666270600076611111111121111131111113210000
111121111111111111121111111111444444424444444111111111121111111112111111111111112112111111111111112121212666666667607026121111111111111111121211110003
111111111111112211112111111111144444424424442111111111111111211111111111112111121111112111121211111211111666666666676766111111111111111111111122123331
111111111111111111111111112111244424444444444411111111111111112111111212111121111211111211121111121111121666666666666666611111111112111121211211111111
211111111111111111111111111111444424444442444411111211111111122121221111111111111211212111211111111211111666666666662666111111111111111121211111111111
112111211121111112211121111112424444442424422111111111111111111211111122211111111111211221112111111111121666666662666666211111111122121111111111111111
112111111111111111111111111111144442244424444411111121111111111111111111111111111111111111111111211121111166666666666666112112111111111111221111211111
111111111111111211111111112112244444444444444411111111212111111121111111111111111111111121121211121111111166266666626666611111111111111111211111211111
111111111111111111111111111111444444444424444111112111111111111112111211122111112111111211121111111111111126666666666666611111111111111111111111111111
111111111112111111112121111112144444444444444112111111112121111212111111121121211111111111111111111111111166666666266662121111112111112111111211111121
111112111111111111111111111111144444244444444411211111111121111111111111111112211112111111111111111211111266666666666666111111111122212112121111111111
111121111111111121112112111112444442444444444111121211121111111112111121111111111112111111111111112111111666666626666666612111111112221111111121111111
211111111211112212111111111111444242424444424211111112121111121112121211111111111121111111121111121112111666666666666266621111111111111111112211111111
111111111111111111111111122111444444444442444421111111111112211211111111111111111111121211111111211121111126666666666266611111211111211111111111221212
122111111111211111111112211111142242444444444111111111112111221111111111111112111221111111111111111122111662666666666662111211111111111111111212122111
121111211111111112111111111111444442444444244211211111111112121111112111111121112111111112111112111111111166666666666666121211121221111111111111111111
111121111112112111111111111111244444244444444411221211211111111111111121111111111111111211111121112211112266666666266266111111111111121111111111111111
111111111121221111111111111111444444444444444411111111111111111121221111111111211121211111111111111111211666666666666262111112111211111111111111111111
211111121111111111121111111111144444444444442411121111111111111112111112112111111111111112121121111111211166666662666662111121111111111111221111121111
111111121121111111111121111111444444444444444411111111112111211111221211111121111111211111111121111111111166666266666666111111111111111111111111121111
112121121112111212111111211111144442444444444411111111111111111112211111122111121111111211111112112212111166666662666626611111111111111111111211112111
111111111111122121111121111121144444442444444111112112111111111211111111111111111111111111111111111221121162626626666662611111111111111121211111111112
111111111111111111111111112111144444444442444221111111111112111111111111112111112211121111111111111111111662626666266666611111111111111121111111111111
112211111111111111111211111111442444444224444411111111111111111121111111111111111111111111211111222111111226666266666666612111121111111221211111111111
121111111111111111111111111111144444444444444411111211121211111211111112111111111121111111111121111111211166662666662666121111121212111112211111111111
111111111111211111111111111121424444444444444111111111121211111111122111112111221211111111111111111111111126666266666666111111111111121111112111221111
112111111111111111111111111121144444244444444211112111211121111111121121112111112122111111211111111111111266666666666666611111112111112111111211111112
111111111111111111112111122111144444444244444411121111111111111211111111111111211121111111111112111121111266666666666666111111111111211111112111121111
211111112112111111111111111112444444444444444411111112111111111111111211111111111111111111111111112211111166666666666666221111111111121111111121111111
112111211111121111111111111211444444444244442111111111121111211111111121121111111211111111112121111112111626666666666266611111111111112111111111111211
111111111111111111111111111111444442444442444211212111211111111111211111122111121111111111211112111111122662266626666666111111111111111111121111121111
111111221211111211111121111111442444244444442421212111111212111211111111111111111111212211111111121111111166662626666666611111112111111211111111111112
111111111212121111121211121111442444444444444411212111211111121111111221111111111111111112122111112111111266662626666666211111211112121111111211121111
121121111111111111112111112111244444444442444111111111112111121212111111211111111111122212112111211111111166666666666666111111121121111111111111111111
111111121221211112211111111111424444444244444211112111111111111111111211121211111111111111111112111111111126666666666666611111111111111112111111112212
111121111111111111111111111111242424424444444411111111111111111121211111111111212111112121111211111111111666666626666666111111111111111111112112111122
111211111111121111211111111112144424224244444111111111111111111121111111111111111111111111111121111111111126666266626666612111111111112211111211111211
111112111111121111111111111111422444424444444411121111111111112111111121111111111111121111111111111111111126262666666666112111111211111111122111211111
112111221111111111121211111111144444444444444121122111112111111211112221111121211111111111121111122221112166666666666666612111111111111121211111111111
111111121211111211111111111121444424244444442411111112111112111221111112121211211111211111111112111111112666666666666666611111111111111111111111111111
111111112111111211111111111112244444444444444111111211111111111121211111111111112111111111111111111111111666666666666266612111111111121111111111111111
112112211111111111111211211111144444444444444411111212111111111121111111111111111111111111112211112111111126666666262666211111211111111111111111111121
111111111121111111211111111111244444444444444411111111211111211111111111111111211111121111111211211111111166662666666666611111212111211111111111111111
212111111111112111212111211211144424444444424411111111211111112121111211111111211111211111211111111111111166666662666662611111111111111111221121111111
111111211112122111211121111111424444244444244411111111111111111111111121111111121112111112221111111212211166666666666666111211111111121111111111111112
111211212111211111111111111111444444444444444111211111111111111111211111211111111111121211112121211111111126626662666662621111111112111111111111111111
211111111111211111111111112111444242424444444411111111111111211111212111111111112111111111111111112112111166666626666666111111111112211111111121111111
221111111211111211121111111111424442444444242111111111111212221111111121211111111111111111111111211112111122626666666626611111211112111111111111211211
212111111211111111111112111111144444444444444111111111221111111112111111111111111111211111111111111111111226666666666662211111212211111111111211211111
111211111111111121112211211112244444444244444121111111112111111112111111122211211111111111111112211111211666626666666666621211111111212111111211111111
121121111111111221111111111111444444444444442111111111211111111111212111111111111111111111111111111121111666666662666626611111121121111111121111111111
111211111111221111111121111111144442444444444411111111121111111111111211122111111111211111111112121111112166666666262662611111111121111111211112121111
111111212111121121111111111111144442244444244111111111121111111111112112111111211111111111111111111111111666662666266666111211112111111111111111111111
111111111111221111111111111111144444242444444421111111111111112111111111212111211211122121111111111111121266666662666262611111112111111111111111111111
111112112211111111111121111111444424444444444411111111111111111111111112111111111121111111122121111111111266666666666266111111211111111111211121111111
111111111111111111111211121121444442442444444411121121111111121112111111121111112121111111111111121111111666266666666266111111111111112211111111112112
211111111121111111111111112121144444424444444411111111111111111111111112111111111211211121111112112111111166666666666266111122111111111121111112111111
121111111111111111111111111211144224444224444111111111122111112111111121111111111111111111121122121111111626666666662266111112111111111112111112111111
112211111111111111111112111111444244444444444111211111211111121111111211111111111111111111211211111112111166666666666626611111211111211111121111112111
111111111121111111111111111212444244444442444411111111111121111121211111111111111211111111111111111111111666666666666666111111111111111111111111111112
111111111121111121111111112111222444224444444411111211111211111111211112112111121111111211121121121111111666666666666666111111112111111111111111111221
111111111111111211111122121211244424444244444111211111111221111111211112111111111112111111111111111121211166666666666662611111111111111111112111111211
112111211111121112211222211111144244444444444412121111111111111111111111121211121111111111112111111111121666666666666666111121111111111111111111111211
121122111111111121211111111112144424424444444411111111211121111121111111111112111111111111111211121111121166666666666666221111111111111111221111121111
111211111111112111111111111111444444444444444111111111111121211111211111211111111111111111211111111111211262266266666662112111111112111211112122111111
121111111111111111111111211111144444422244444411111121121111111211211111111111111111111211121121111111112666666666662666111111111111111111111111122221
112112211111121112111111111122424444444244444412111111111111211111111111111111112111111111111111111111111266666666666666111111111211111111111111111121
112111211111111111221112112111444244242444424112111111111111211211111122222112111121121111221111111111111162666666666666111111121111211112111211111111
211111111111111111111111111111144424442444444121122111111111111111111111211111111111111111211111111121111666266266666626111112112111122111111121111111
111211121111211111111111111111444442444444444411121112111111111111112111111111121111111111212211112112121666662666666626611121111111111111122111121121
111111111121111111111111111211144444442444444411111111112111111112211111122112111111111111111111121112111166666666666662111111121211111111112111111211
111221111112111111111211111111144444424424444111111122111112111111121111111111111111221111111111112111111666666666266662121111121111111122111112111111
112111112111111111111112111111144444444444244411111111111111211112111121111121111111111111111111111111111666266666666666111111121121111111211111111121
211111111111112111121111121111124444444444424111121111111111111121111211111121211111111111111111111112112126666666666626111111111112111112112111112111
111111111111111111111211121111444444444442444111111111121121112111111111111212111121111111112112121112111666626666266666621111111122111111212111111111
111111121111211211111111111111444444242444444411211111111111112111112112111121111111111111121111111111112166666666666266611112111211111111121111211111
111111121121111211121111111121122444444424444221111121111111111111111211112111111111111111111111111122111222266626666666111111111211111121111111121111
122111111111111211121121111211244444244444424411111111111111211111111111111112111111111121111111211211111166666666666666611111111111111111112112111111
121111121111111211111112111111144444444444444111112111111111112111111111111111111111112111111111111111111126666666666666611111121111111111111211111111
111111111111111111111212111111244444444444444111111121121111111211111111111111211121111111112112111111111666666266626626211212111112111111121211111111
111111211122111112221111111111144444422444444411111111111212121111211111111111111211111111111111121111111166666666666666611111111111211111211111111111
111111112111111211111111111111244244444444444411111211111112111111111111111111112211111111211111111111111226666666666626111111111111211111122121111112
111111111111111111121121111112424444444444424121122111112111111111111111111111111111111111111111111111111666666666666266611111121111111111111111111111
111112121121111111111211221211144244244442444411112111111112111111111111111121111111121111111121111111111626626666666666211112211211111111112111112211
111111111111111111111121111121144444444444424111111111111111111111111111111111111111111111111111111111111666666666666626111111111212111111122111111111
111111111111111111111212211111244444242242244411112112111111111111111211112111111122111111111121111111111666666666666666612111211111111111111111121111
111111211111111112111211111111444424444442444111121111121111111111111111121111121112111111111112111111111666266262226666211112112111211112111111111111
111112111111111111111111111212144244444444244411111121111111111221112111111112111111111111111111111211111166666266666666611111111121111111121111111112
111111111111111111112111111121144444444444444411111111121111111111111121111111111111112111111211111111121666666666626666221111111111111111111112211111
111212112111112111111111111121144444444242444121111111121111112111112111111111111111111111111111111121112166666666626662611111111121121111111111121111
121111111121111111111111111111242444244444444111111211111111121112111111221121111112111122121112111121121166662666666662611111112111211111221111212211
112111111111111111111111111111444444444244424421111111111111121112111111111111111111121121211111211111211666626666622666611111111111111111111111112111