000000000000000000000000000000000000000000000000000000000000000000000000000000000000000000000000000000000000000000000000000000000000000000000000000000
000000000000000000000000000000000000000000000000000000000000000000000000000000000000000000000000000000000000000000000000000000000000000000000000000000
000000000000000000000000000000000000000000000000000000000000000000000000000000000000000000000000000000000000000000000000000000000000000000000000000000
000000000000000000000000000000000000000000000000000000000000000000000000000000000000000000000000000000000000000000000000000000000000000000000000000000
000000000000000000000000000000000000000000000000000000000000000000000000000000000000000000000000000000000000000000000000000000000000000000000000000000
000000000000000000000000000000000000000000000000000000000000000000000000000000000000000000000000000000000000000000000000000000000000000000000000000000
000000000000000000000000000000000000000000000000000000000000000000000000000000000000000000000000000000000000000000000000000000000000000000000000000000
000000000000000000000000000000000000000000000000000000000000000000000000000000000000000000000000000000000000000000000000000000000000000000000000000000
000000000000000000000000000000000000000000000000000000000000000000000000000000000000000000000000000000000000000000000000000000000000000000000000000000
000000000000000000000000000000000000000000000000000000000000000000000000000000000000000000000000000000000000000000000000000000000000000000000000000000
000000000000000000000000000000000000000000000000000000000000000000000000000000000000000000000000000000000000000000000000000000000000000000000000000000
000000000000000000000000000000000000000000000000000000000000000000000000000000000000000000000000000000000000000000000000000000000000000000000000000000
000000000000000000000000000000000000000000000000000000000000000000000000000000000000000000000000000000000000000000000000000000000000000000000000000000
000000000000000000000000000000000000000000000000000000000000000000000000000000000000000000000000000000000000000000000000000000000000000000000000000000
000000000000000000000000000000000000000000000000000000000000000000000000000000000000000000000000000000000000000000000000000000000000000000000000000000
000000000000000000000000000000000000000000000000000000000000000000000000000000000000000000000000000000000000000000000000000000000000000000000000000000
000000000000000000000000000000000000000000000000000000000000000000000000000000000000000000000000000000000000000000000000000000000000000000000000000000
000000000000000000000000000000000000000000000000000000000000000000000000000000000000000000000000000000000000000000000000000000000000000000000000000000
000000000000000000000000000000000000000000000000000000000000000000000000000000000000000000000000000000000000000000000000000000000000000000000000000000
000000000000000000000000000000000000000000000000000000000000000000000000000000000000000000000000000000000000000000000000000000000000000000000000000000
000000000000000000000000000000000000000000000000000000000000000000000000000000000000000000000000000000000000000000000000000000000000000000000000000000
000000000000000000000000000000000000000000000000000000000000000000000000000000000000000000000000000000000000000000000000000000000000000000000000000000
000000000000000000000000000000000000000000000000000000000000000000000000000000000000000000000000000000000000000000000000000000000000000000000000000000
000000000000000000000000000000000000000000000000000000000000000000000000000000000000000000000000000000000000000000000000000000000000000000000000000000
000000000000000000000000000000000000000000000000000000000000000000000000000000000000000000000000000000000000000000000000000000000000000000000000000000
000000000000000000000000000000000000000000000000000000000000000000000000000000000000000000000000000000000000000000000000000000000000000000000000000000
000000000000000000000000000000000000000000000000000000000000000000000000000000000000000000000000000000000000000000000000000000000000000000000000000000
000000000000000000000000000000000000000000000000000000000000000000000000000000000000000000000000000000000000000000000000000000000000000000000000000000
000000000000000000000000000000000000000000000000000000000000000000000000000000000000000000000000000000000000000000000000000000000000000000000000000000
000000000000000000000000000000000000000000000000000000000000000000000000000000000000000000000000000000000000000000000000000000000000000000000000000000
000000000000000000000000000000000000000000000000000000000000000000000000000900000000000000000000000000000000000000000000000000000000000000000000000000
000000000000000000000000000000000000000000000000000000000000000000000000000000000000000000000000000000000000000000000000000000000000000000000000000000
000000000000000000000000000000000000000000000000000000000000000000000000000000000000000000000000000000000000000000000000000000000000000000000000000000
000000000000000000000000000000000000000000000000000000000000000000000000000000000000000000000000000000000000000000000000000000000000000000000000000000
000000000000000000000000000000000000000000000000000000000000000000000000000000000000000000000000000000000000000000000000000000000000000000000000000000
000000000000000000000000000000000000000000000000000000000000000000000000000000000000000000000000000000000000000000000000000000000000000000000000000000
000000000000000000000000000000000000000000000000000000000000000000000000000000000000000000000000000000000000000000000000000000000000000000000000000000
000000000000000000000000000000000000000000000000000000000000000000000000000000000000000000000000000000000000000000000000000000000000000000000000000000
000000000000000000000000000000000000000000000000000000000000000000000000000000000000000000000000000000000000000000000000000000000000000000000000000000
000000000000000000000000000000000000000000000000000000000000000000000000000000000000000000000000000000000000000000000000000000000000000000000000000000
000000000000000000000000000000000000000000000000000000000000000000000000000000000000000000000000000000000000000000000000000000000000000000000000000000
000000000000000000000000000000000000000000000000000000000000000000000000000000000000000000000000000000000000000000000000000000000000000000000000000000
000000000000000000000000000000000000000000000000000000000000000000000000000000000000000000000000000000000000000000000000000000000000000000000000000000
000000000000000000000000000000000000000000000000000000000000000000000000000000000000000000000000000000000000000000000000000000000000000000000000000000
000000000000000000000000000000000000000000000000000000000000000000000000000000000000000000000000000000000000000000000000000000000000000000000000000000
300000000000000000000000000000000000000000000000000000000000000000000000000000000000000000000000000000000000000000000000000000000000000000000000000000
130000000000000000000000000000000000000000000000000000000000000000000000000000000000000000000000000000000000000000000000000000000000000000000000000000
110000000000000000000000000000000000000000000000000000000000000000000000000000000000000000000000000000000000000000000000000000000000000000000000000000
113000000000000000000000000000000000000000000000000000000000000000000000000000000000000000000000000000000000000000000000000000000000000000000000000000
111000000000000000000000000000000000000000000000000000000000000000000000000000000000000000000000000000000000000000000000000000000000000000000000000000
111330000000000000000000000000000000000000000000000000000000000000000000000000000000000000000000000000000000000000000000000000000000000000000000000000
111110000000000000000000000000000000000000000000000000000000000000000000000000000000000000000000000000000000000000000000000000000000000000000000000000
111110000000000000000000000000000000000000000000000000000000000000000000000000000000000000003000000000000000000000000000000000000000000000000000000000
111113030000000000000000000000000000000000000000000000000000000000000000003003330000000000001330000000000000000000000000000000000000000000000000000000
111111010000000000000000000000000000000000000000000000000000000000000000031301110000000000331110000000000000000000000000000000000000000000000000000000
111111310000000000000000000000000003000000000000000000000000000003000000011131113300000333111110000000000000000000000003000000000000000000000000000000
111111113300000000000000333000000031300000000000000000000000000301000000311111111130000111111113000000000000000000000001000000000000000000000000000000
111111111100000000000000111303330311130000000003033330000000000131300003111111111110303111111111000000000000000000000031030030000000000000000000000330
111111111103000000033033111131110111113030000331311110300000003111100031111111111110131111111111000000300000000033000011310310300000000000030300030113
111111111131300330311011111111113111111010000111111113100000001111130011111111111113111111111111300000103330000311000311113113100000030000010103313111
111111111111133113111311111111111111111313333111111111133333331111113311111111111111111111111111133333131113333111333111111111133333313333313131111111
211111121211221112111112112111111111111111111121111111111111111111111111112211211111111111111112112111221122211121121111111111111121211111111111111111
111111111111121111221211111112111111111111111111111111111121211111111111111121111121111121111111111211111221111111111111111111111112111112111121112111
112121112121111111111121111212111111111211112111111112111112111212112111111112111121121111112111111121111111111111111112121111211112111111111112121111
111111121111111112212111111111111111211111111111121111111111111112111111121111111111111111111211111111111111111111111111111112112111111212121111111111
211211111112111111111111111111121111111111111111112111111111211111111111111111111221111111211111211211212121121111121111111111111111111111122111111111
111111111111111112111111111111111111111212111111111111211111111111111112111112111112211111111211111111121111111111111111112111111111111111211121111111
121211211111111112111111111122111111111211212122121111121111111211111111212111111111121111112111111111212111111111111111111111111111111111111111121112
111111111121212111211111111111111112112111121111212111112111212111111111211111111211111111111112111112111111111212111111211111111111112111111121111121
111211111111121111111111111111111111111222211111121211111111111111211121111121111111112111111122111111111111112211112111111111111112111111111111111111
111111211111111121111111112111111111111111111111111111111211111121111211111211111111111112111111111211111211112211111111111221111111111112111111111121
111122111111111111221111111111111111111112111111111111121121112111111121211121112111122111111111111111111111111111111111111111212211211211111111111222
111111111111211111111111111111111111111111121111111111111111111111111122121112111111111111121111211211112111111211111111111112111211111111111111111211
111111111211121111111111111221211111112211122211111111122111111121111111211111122121111111111111111111112111111111112121112111111121111111111221211211
111121111112112111111111111111111111111111112111111111122211111111111211111111111111111111121111111221111111111111112111111111111111111111111112111111
221111111112121111211111121121112111111111111111111121111211111111112111111111111111111111111112111111211111121111211111111111111111121112121121121112
111212111121121111121211111111211112111111111111211221111111111112111111111111111111111111112112111111211211111212111111111111121121211111111111111111
121111111111111111111111111111111111111211221111112121111111111121111111111211112121111211111211112111111211111222111112111111111111221112211111121111
111112111212111111111111111211112111211121111111111111111111121211121111112112111121112111111212211121111221112111121112111111111111111112112111122111
111112112111111121222111111111111111111111111111112111111121112121122111121211111111111111111111111111111111211111111111221111111111112111111111111111
121111121111121111111212111111121211111111221112121121111211111111111112111121111111211211112111111211111212122111221111111112211111121111111121211111
111111111111121111211111211121112111121112111111211121111111111111111111111111211111111111121111112121111111211212121221111111121211211111122111111111
111111111211121112111111111111211111111111111111111121211111111111112111211111111222111111111122111111111121111111111211111111111111122111111111111111
211111111212121111111111121111111211111211111111111111111111111111112111111111111111111111111211111111111111111112111111111211111111121111111112111121
112111111211111211111111111111111111111111111111111111211112211111111111111111211211111111111111111111111111111111111211111111111111111212111111112112
111111111111111111111111211111111111121112111112111211211111111112111111112111111111112111121121111221111111111111111111211111111112122212211112121122
211121211112121111111111111111121111211111211122111121111111121111111111111111111121111111111112111111112111211111211112121221111111111111111211111111
211211111111111111211111211211111121111121111211121111212111112112111111121111211122121111111111111111111121111211111111111211212111111111112111111121
111211111111111111111111111111111111111111111111111112111112111121111211111111111111221111211111111111212121111111111111112111211111111111112111111212
111111111111121111121112121111211111111211111111221111111211112111111112121121111111111111211111111111111111111111111111111111111111111121111111112111
211111122121111111212111111111121111211111111111111111111111111111111111111111111112111111111111221111111111121112111111111121111111112112111112111111
111111111121111112111111111111111111111111111111111111211111111111111111111111111111111111111111111111111111111121121111111111111111111111111112111111
111121111121111111111111112111111211111211111112111112111111121112111111111111211111112111111111121212111111111122221112111111111211111111112111112111
111121111111111111111111111111111112112111211111111121111111121111111111221111111111122111111221121211111111111111111111111211111111121111211111111221
111111111111121211211111111111111111112111111112111211111111111111211111111211111111111111211111111111111112111211121111111111112111111211111112112111
211121111111111111111121111111111111111121111111111211111111112121111111111211121111111111111111111111121111111211111111111111111111121111112111112111
111111111111212111121112111111112211111211111111111111121111111121111111111111111112111111121211111111111111121111112121111111111111121111111111111111
111111112112111121111111111111211111111111111111211111111111111212111112111121111122111111121111111112111111111221111111111111111111211111111211211111
111121111121111112111121111111112111111211111111111112111111111211111111111211121111211112111111111121111111112111111111111111111111111111111111121211
111122111111121111111111111111211111111211111111211112111111111221121111111111111111221121111121111111111111212211111111111111111211111111121111111111
111111121111111111111111121111111111211111111112111111112111111111211111111111111111111112121121111111111112121111111211111112121111112111111111211111
111111111212212112112111111111111111211111111111121111111111111121111121111111111111111111121111111111221211111111111111111111111211111111111111211111
121121211111112111111111111111111112111221112112111111111211112111121111111211122111111112111111112111111112112111111111211112112111111111111112111111
111121121111111111111111111111112111121111112111111112111111111111111111111211111111111111111211112111111111111112111111111111111111111111111121111111
111111111111112121111111111112211111111111111111212111211111121211112121121111121111222111111111111112111111111111111111111111111111111111211111121121
111112111111111222111112111111111111211111111111211111111211112121111211111111211112111111221111111111111111211111111212111111111111111111111112112111
111111121111112111111111122111111211111111111111121111111111111211111111111111111111212112111211121111111111111211111111111111111222111111111121111112
111111111121222112211121111211211111111111111111111111111111112111211111111111111221111111121111111111111112111111121111121112111111111112111111111212
111112111111111112211121211111121111111111111111111111211211111111112212211111211121211111111111111111111121111112111112111111111111111111112121121111
111211121111121211211111112111212121121211111111111211111111121111121221111111111111111112112112111111111111111111221112111111111111111121111211111111
111111111111111111111111121111111111111211111122111121111111111111111221111111121111111111111211111111111111111112112111112111111111111111111112111111
121111121211111121111111111121111111111111111111111111112121111111112111211111121211112111111111111111121211121211211111111211111111111111111111122211
112112111121121111111111111111111111111111211111111211111112111111111111111111111121111112111111111112211112111111111211111211111111111111111111211111
111111111111111112111111111111111111111111111111111111111111111111111112111211111112121111121221111111111111111111112112111111111211111111111112111221
112111111111111112212111111111112111111111111111111111111111121111112111111111111112111111111111111112111111121211211211211111111111112121122111211221
111111111111122111111112111111121111211111222111111122111111211111111121111111111111111111111111111111111112111211111211112221111112111111221111211221
111111112111111111111211111111111112111122112111111111111211111121112121111211111111111111121111111111112111111111111111111111111111112111111111112121
112111111111111112111111111111111111211111211111111121111111111111121111122112111111111111111212121112111211121111121111111112111111111121111111111211
112111111111121111211111121111111111111111111111111111112112111111111111111211111111111221112111211111112111112111111122122111112111211111111111111111
111112111121121111111112111111111121111111111111211121211111212121111111111111111111111111111111111211211111111211111112111222121211111112111121111111
111212111111111111111111111111111111111111111111111112111211111121121111111111111211111111111111111111111111211121211211111111121121121111111111111112
111111111112112111111121111111111121111111111111111111112111111111111111111111112111111111211111111121111111211111111121111112211111111121111111211111
111111111111111111111111111111111111111111111211111111111111111111121111111111111111111111111111112111112111111111111111111121111111211111111121111111
111111111111111111111112111111111111111111111211111111121111211111111111111111111111121111111111111111111112121111211112111111111111111211221111111111
111211112111111121211111111121111111111111111111111111111111111211121111111121121121211112211121111111121111112121121111111121111111111111111111111111
111111111111112111111112121111211111121121111111112111111111111111121112111111111111212111111121112121211111112111111111111211111121112211121111112111
111112111111111111111111111211211211111111121111211111111111111111212111111121211211111111112111111111111111122111111111121111211121111111121111121112
121111122112111111111112211121111221111111111111211111111111111111212112111111111111111111111111221111111111111111111211111111111111111211111121111111
111112112111111111111111121111121111111111121121112111211111112111111121111211121121111121111111111121111111111121112211111111111111121121211211111111
111111111212121211111211111111121111111111111112111111111111121111111211111111112111111111111111111221111112111111211111111211111111111111121111111111
111111111111111111112111111111211122121211111111111121111112111111111111111111111111112111211221111121111121111111111111121121121112111112211111121111
111112111111111111111121111111111111111111121121111112111111111122111122121211111111111111111112112111112112111111111111111111111121112111111111111111
111112111111111111111121111111111111211111111111111112121121111111211111111111111211111111111111111111111111111111211111112111121111121112111111111221
111111111111111112111111211111211121112111111111211111111111111121111111112111111121111112111211211111121111111111112111111121121111111111111121111121
111111111111121111111121111111122111111211111111111212111111111112111112111111111111111122111111211111111111111111211112221111111111111112111211211111
111121111111111111111111111111111111111111111111211111111111121211111121111112111112111111112212221111112112111111111111111111111111111111111112121111
111111111111111111111111121111111121111111111111112121111211112111111111111121111111111111111121211111121111111112111111111212111111111111111111111111
211111112211111121111111111211111111111121111111121111111111111111111111111111111111111111111121111111111111111112211111112111221111112111111211121111
121111111111111111111122121112211111111111111111121211111111111111122111211112111211121212221111111121111111122111111111112111111211111111111111111111
111111111121111111111121111121111112211112111111111211111111122111111111111111121112111111222211211111112121111121111121111111121211112111211111111111
111112111111111111121111111111211211111111121112111111211111211111211112112211111111111112111111111111111112111111111212111121211121121111221111111111
112211111111112211112111111111111121111111111111112121112111211111112111111111111111111121121211111111111111121111111111211111111111111121111112111111
112111211111111111221211111111111112111212211111111212211112111111211112112211112111111111111112111111111111111111121112121111112111111111111111111111
111111111111121111111111112112211111111111111111111211111112111112111212111111112111111121111111211111111111212112111111111111111121211111111111111222
111111211111111111111111111211111111111111111211111211111211121111111111111111111211111221111111211111111111111111111111211111112111111111111112111121
111111111111112111111111111111121111122111211111112111112122111111111111111111121111111121222221111111111111121111111121121111111111111121111111111121
112111111111111111111111111111111211121121111111112111111111111111111111111112111112111111211111111211111111111111111111111111111111112111111111221111
111111211221111111111111211211111111111111111111111111121111111112111121211111111112111111111111111111111121221111111111111111112111111111212112111111
221121111121212111111111111111111111212112111111112111111111111111111111111111121111111211221111111111111111111112111211111211111111112111111111121221
112111111111211112112111111111221111111211111112111111111111211121121111111111111112121111111111121111111111111112111111212111111111111111121111111111