0000000000000000000000000000000000000000000000000000000000000000000000000000000000000000000000000000
0000000000000000000000000000000000000000000000000000000000000000000000000000000000000000000000000000
0000000000000000000000000000000000000000000000000000000000000000000000000000000000000000000000000000
0000000000000000000000000000000000000000000000000000000000000000000000000000000000000000000000000000
0000000000000000000000000000000000000000000000000000000000000000000000000000000000000000000000000000
0000000000000000000000000000000000000000000000000000000000000000000000000000000000000000000000000000
0000000000000000000000000000000000000000000000000000000000000000000000000000000000000000000000000000
0000000000000000000000000000000000000000000000000000000000000000000000000000000000000000000000000000
0000000000000000000000000000000000000000000000000000000000000000000000000000000000000000000000000000
0000000000000000000000000000000000000000000000000000000000000000000000000000000000000000000000000000
0000000000000000000000000000000000000000000000000000000000000000000000000000000000000000000000000000
0000000000000000000000000000000000000000000000000000000000000000000000000000000000000000000000000000
0000000000000000000000000000000000000000000000000000000000000000000000000000000000000000000000000000
0000000000000000000000000000000000000000000000000000000000000000000000000000000000000000000000000000
0000000000000000000000000000000000000000000000000000000000000000000000000000000000000000000000000000
0000000000000000000000000000000000000000000000000000000000000000000000000000000000000000000000000000
0000000000000000000000000000000000000000000000000000000000000000000000000000000000000000000000000000
0000000000000000000000000000000000000000000000000000000000000000000000000000000000000000000000000000
0000000000000000000000000000000000000000000000000090000000000000000000000000000000000000000000000000
0000000000000000000000000000000000000000000000000000000000000000000000000000000000000000000000000000
1100000000000010100000000000000000000000000000000000000000000000000000000000000000000000000000000000
1110000000001111110000010000110000000000000000000000000000000000000000000000000000000000000000000000
1110000000011111111000010100110000000000000000000000000000000000000000000000000000000000000000000000
1111000000011111111000111101111000000100000000000000000000100000000000000000000000000000000000000000
1111000001111111111100111111111001000111100000000000000110111000000000000000000000000000000000000000
1111111101111111111111111111111101011111110000000000100111111000000000000000000000000000000000000000
1111111111111111111111111111111111111111111000000000101111111110000000000000000000000000000000000000
1111111111111111111111111111111111111111111100000011111111111110000000000000000000000000000000000000
1111111111111111111111111111111111111111111100000011111111111111000000000000000000000000000000000000
1111111111111111111111111111111111111111111111000111111111111111110000000000000000000000000000000000
1111111111111111111111111111111111111111111111000111111111111111111000000000000000000000000000000000
1111111111111111111111111111111111111111111111101111111111111111111010000000000000000000000000000000
1111111111111111111111111111111111111111111111111111111111111111111111101000000000000000000000000000
1111111111111111111111111111111111111111111111111111111111111111111111101100000100000000000000000000
1111111111111111111111111111111111111111111111111111111111111111111111111111011110000000000000000000
1111111111111111111111111111111111111111111111111111111111111111111111111111011111000000000000000000
1111111111111111111111111111111111111111111111111111111111111111111111111111111111110000000010001100
1111111111111111111111111111111111111111111111111111111111111111111111111111111111110000001111111110
1111111111111111111111111111111111111111111111111111111111111111111111111111111111111001111111111111
1111111111111111111111111111111111111111111111111111111111111111111111111111111111111001111111111111
1111111111111111111111111111111111111111111111111111111111111111111111111111111111111111111111111111
1121211121111111112111111111111211111212111111211112112111111122211111111111211111111111111111111111
2111121121111111111111211111112211211122111112111111111212122111211111111211111211211111111211211211
1111111111111111111111112111111111111111111111111211112111111112112111121111111111111111111111221111
1111111211112112111211112111111111111111111111112111111112111112121211111111112111111111211111121111
1121112111111111111111111111111111111111111211111121111121112111211111122121111111111121111111211111
1111111121111111111111111121111111111111211111111111111111112121111111111111111112111111111121111111
1111111122111111111112111111211111111111111111112111111111111111121111111112212111121211112111111111
1112111111111111111111111211111111111111111112111211111111111111111211111111111111111111111111111112
1211211111211111111112111211111111111111112111112112111111111111121121111112211111111211211111211111
1111111111112111121112111111111111112111111111111122121112211111112111111111111111111211111111111111
1111111111111111111212211111111111111121111111111111112111111112111111111111111112211111121111211212
1211211111121111111111111211121211211111111111112111121211111121111211221111111111111211111111121112
1212111111111111221121111111111112211121111111111121111111111111111111111111111111112111112111111211
1122111111111121111212111211111111111212112111111111111111111111112111111111112112111212111111212111
1111211211111111121111111111111111111111111111211211111111111111111112111111111211111111211111111121
1111111221111111111122111121111111111112112121111111111112111122111121111111111112111111111111122111
1212111111111112121211111111111111111111221111111111111112111221111111111111111111111211111111111111
1111111111111111111111111112112121111112111121112121121111111111112121112111111111111121111211111111
2112111111111111111112111121111121111111111111211111111111111111111211121211111111112112111111111111
1112121112111112121111112111111111111221112111111111111211112111112111212111111211111111111111111121
1121111111111121211211211111112121121111111111111111121111111211111111112111111112111211211111111111
1111111211121121111111211111111112211111111111111111111111111111111112211111111111111111121111221111
1111111111111121111121111111112111211111111111111111111111111111112111211112111112111221111111111111
1111111111121111111111111111121111111112111111112112121111111111212111121111111111121122121111121111
2111111211111112121111211111111111111211111112111212111111112111111111111121111211112111112111111111
1121111111112111111111111111111121111112111211111211211111111111111221111121111111111111111111111111
1111111111112111111211111111111111111111111211111111111111121211112211112111111111111111111112111121
1111111111111211111111112111111211111111112111111111111111111111111112121111111211211221112111111111
1111111111112111122111111111111111112111111111112211211212111111112111111111211211111111211112121211
1111111221211121111111121111111111111111111112121111111111111121111111111111121111121112121111111211
2121111121111111121111121111111111211112111111111211112121121212112212121111111112111112121111111111
1111211111111111111111111111111111111111111111111111121111111111111112112111111121111111211211121121
1111211111111111112111121111112111111111111112111121211111111112111121111121111111111111111111112121
1111111111111111112111112111111111111111111211111111111111211112112112111211112111111111111111111111
1221111111121111111112211111122112111111111111111111111111111111112111112111111111111111111111111211
1111111111111111111111111111112121112111211111111111111112111111111111111111112111111111111121111211
1111111112111121111111121221111111112122111122112112221111111221111122111111111111111111111111111111
1111111111111111111111111121111211211121211111111111111111111211111121111211111112112111112111111211
1112111111121111111112111111111112212211111211111111111111112111112221111121111211111111111111111121
1212111111112111111111111121111111111111211211121211111111111111111111111111121111111111111211111111
1111111111111112111111211111111111111112111121111111211112212112111111111111111111111211111112122111
1111212111212121111212111112111111111111111111111111112111111121111111111112211121111112111112111111
1112111111111111111111112112111111111111112121121111112111111111111111111122121111211212111211111111
1212121111111111111112121211111111212111111111111111122111211111112121111111111111111111121111112111
2111111211211111111111112122121121111111111121211211111112211111111111111111121111111111111111111111
1111211111111122111121111111111121111121211111121111111211122111111112111111111111111111111111111211
1111111111121211121121211111112111111111211112111121111112111121111111111111111212112121111121111111
1121111111111111111111111121111121111111111111111121111121221111211121111111111121221111111112112211
2111112212111121111111111111111211122121212111121111111211111111112111111111122111111121111111111111
2111111111211111111111111111121111111211111111111111111211111111112111111211112221111111121111111111
1111111111111211111111111111111211111111112111112111111112111111111111111111111111111111112211121111
1111111112111111111111111111111111211111112111111111111111121112111111111211121111111111111112111112
1111121111211112111111111112111121111111111111111111211112211111112121111212111111112111111111111211
1111211111111111221111111111111211121111121112111112121111111111121111211111111111112211111111112111
1111111111211121221111111111111111111111211111111111211111121111111112111112112111111112212112221111
1111221112111111111211111211111111111111112111211211121221111111111111111111212211111211111111111112
1111111121111111111111111111111111111121111121111111111211111111111222111111112211111111111212122111
1112111211111111111112211111121111121111111111111211111111111112112111111211121111111121111121111111
1121112211111112111212111111221111112111111111211112111112211111112111111112111111111121122111111212